Ms, Ms, Ms, Ms, Ms, Ms, Ms, Ms, Xu, Xu, Xu, Xu, Xu, Xu, Xu, Xu, Xu, Xu, Xu, Xu, Xu, Xu, Xu, Xu, Wo, Xu, Xu, Xu, Xu, Xu, Xu, Xu, Xu, Xu, Xu, Xu, Xu, Xu, Xu, Xu, Xu, Xu, Xu
Ms, Ms, Ms, Ms, Ms, Ms, Ms, Ms, Ms, Xu, Xu, Xu, Xu, Xu, Xu, Xu, Xu, Xu, Xu, Xu, Xu, Xu, Xu, Xu, Wo, Xu, Xu, Xu, Xu, Xu, Xu, Xu, Xu, Xu, Xu, Xu, Xu, Xu, Xu, Xu, Xu, Xu, Xu
Ms, Ms, Ms, Ms, Ms, Ms, Ms, Ms, Ms, Ms, Ms, Xu, Xu, Xu, Xu, Xu, Xu, Xu, Xu, Xu, Xu, Xu, Xu, Xu, Xu, Wo, Xu, Xu, Xu, Xu, Xu, Xu, Xu, Xu, Xu, Xu, Xu, Xu, Xu, Xu, Xu, Xu, Xu
Ms, Ms, Ms, Ms, Ms, Ms, Ms, Ms, Ms, Ms, Ms, Xu, Xu, Xu, Xu, Xu, Xu, Xu, Xu, Xu, Xu, Xu, Xu, Xu, Xu, Wo, Wo, Xu, Xu, Xu, Xu, Xu, Xu, Xu, Xu, Xu, Wo, Xu, Wo, Xu, Xu, Xu, Xu
Ms, Ms, Ms, Ms, Ms, Ms, Ms, Ms, Ms, Ms, Ms, Ms, Xu, Xu, Xu, Xu, Xu, Xu, Xu, Xu, Xu, Xu, Xu, Xu, Xu, Xu, Xu, Wo, Wo, Xu, Xu, Xu, Xu, Xu, Wo, Wo, Xu, Wo, Xu, Xu, Xu, Xu, Xu
Ms, Ms, Ms, Qxu, Qxu, Ms, Ms, Ms, Ms, Ms, Ms, Ms, Ms, Xu, Xu, Xu, Xu, Xu, Xu, Xu, Xu, Xu, Xu, Xu, Xu, Xu, Xu, Xu, Wo, Xu, Xu, Xu, Xu, Xu, Wo, Xu, Xu, Xu, Xu, Xu, Xu, Xu, Xu
Ms, Ms, Ms, Ms, Qxu, Qxu, Ms, Ms, Ms, Ms, Ms, Qxu, Ms, Xu, Xu, Xu, Xu, Xu, Xu, Xu, Wo, Xu, Xu, Xu, Xu, Xu, Xu, Xu, Xu, Wo, Xu, Xu, Xu, Wo, Xu, Xu, Xu, Xu, Xu, Xu, Xu, Xu, Xu
Ms, Ms, Ms, Ms, Qxu, Ms, Ms, Ms, Qxu, Ms, Qxu, Qxu, Qxu, Ms, Xu, Xu, Xu, Wo, Wo, Wo, Xu, Wo, Xu, Xu, Xu, Xu, Xu, Xu, Xu, Wo, Wo, Wo, Wo, Wo, Xu, Xu, Xu, Xu, Xu, Xu, Xu, Xu, Xu
Ms, Ms, Ms, Qxu, Ha, Qxu, Ms, Ms, Ha, Qxu, Ms, Ms, Ms, Ms, Xu, Xu, Xu, Xu, Xu, Xu, Xu, Wo, Wo, Xu, Xu, Xu, Xu, Xu, Xu, Wo, Xu, Xu, Xu, Xu, Xu, Xu, Xu, Xu, Xu, Xu, Xu, Xu, Xu
Ha^Fda, Ms, Ms, Ms, Ha, Ha, Ha, Ms, Ha^Fda, Ha, Ha, Ms, Ms, Ms, Ms, Xu, Xu, Xu, Xu, Xu, Xu, Xu, Xu, Wo, Uh, Ur^Qov, Uh, Xu, Ww^Es, Wo, Xu, Xu, Xu, Xu, Xu, Xu, Xu, Xu, Xu, Xu, Xu, Xu, Xu
Ha^Fda, Ha^Fda, Ha^Fda, Ha^Fda, Ms, Ms, Ha^Fda, Ha, Ha^Fda, Ha^Fda, Aa^Fda, Ha, Ha^Fda, Ms, Ms, Xu, Xu, Xu, Xu, Xu, Xu, Xu, Xu, Ww^Es, Ww, Uu, Wwr^Es, Wwr^Es, Wwr^Es, Xu, Xu, Xu, Xu, Xu, Xu, Wo, Wo, Xu, Xu, Xu, Xu, Xu, Xu
Aa^Fda, Ha, Aa, Ms, Ms, Ms^Voa, Ms, Ha^Fda, Ha, Aa^Fda, Aa^Fda, Ms, Aa^Fda, Ms, Ms, Ms, Xu, Xu, Xu, Xu, Ur^Qov, Uu^Em, Xu, Uh, Wwr^Em, Wwr^Es, Wwr^Es, Uu^Vu, Wwr^Es, Uh, Ur^Qov, Xu, Xu, Xu, Xu, Xu, Wo, Xu, Xu, Xu, Xu, Xu, Xu
Aa, Aa^Fda, Rb, Aa^Fda, Rb, Ms, Ms, Ms, Ha^Fda, Ha^Fda, Aa^Fda, Aa^Feta, Aa, Aa^Fda, Ms, Ms, Ms, Ms, Xu, Xu, Uu, Uu^Em, Wwr, Wwr^Em, Tb^Tf, Uu^Qhh, Uu^Qhh, Wwr^Es, Wwr^Es, Uu^Em, Uh, Xu, Wo, Xu, Wo, Wo, Xu, Xu, Xu, Xu, Xu, Xu, Xu
Rb, Rb, Ms, Rb, Ms, Rb, Rb, Rb, Rb, Aa, Rb, Aa^Fda, Rb, Aa^Fda, Rb, Rb, Rb, Rb, Rb, Uu, Uu, Uu, Wwr, Uu^Qhh, Xu^Qhh, Uh^Qhh, Xu^Qhh, Uu^Qhh, Wwr^Em, Ww^Es, Ww, Ww, Xu, Wo, Xu, Wo, Wo, Xu, Wo, Xu, Xu, Xu, Xu
Ha^Fpa, Ms, Ms, Ms, Ms, Ms, Ms, Ms, Rb, Rb, Ms, Rb, Ms, Rb, Ha, Ha, Ha, Ha, Xu, Uu, Uu, Uu^Vu, Wwr, Uu^Qhh, Uh^Qhh, 2 Kte^Ii, Uh^Qhh, Tb^Tf, Wwr^Em, Uh, Xu, Xu, Xu, Xu, Xu, Xu, Xu, Wo, Xu, Wo, Wo, Xu, Wo
Ms, Ms, Ms, Ms, Ms, Ms, Ms, Rb, Ms^Vca, Ms, Ms, Ms, Ms, Ha, Ms, Ms, Ms, Ms, Xu, Xu, Uh, Uu, Wwr^Es, Uu^Qhh, Uu^Qhh, Xu^Qhh, Uu^Qhh, Uu^Qhh, Wwr, Xu, Uh, Xu, Xu, Xu, Xu, Xu, Xu, Xu, Xu, Xu, Xu, Wo, Xu
Ms, Ms, Ms, Qxu, Ms, Ms, Rb, Rb, Ms, Ms, Qxu, Ms, Ms, Ha, Ha, Ms, Xu, Xu, Xu, Xu, Ur^Qov, Uu, Ww^Es, Wwr^Es, Wwr^Es, Uu^Qhh, Wwr^Es, Wwr, Uu, Uu^Em, Ur^Qov, Xu, Xu, Xu, Xu, Xu, Xu, Xu, Xu, Xu, Xu, Xu, Xu
Qxu, Ms, Qxu, Qxu, Ha, Ms, Rb, Ms, Ha, Ha, Qxu, Ms, Ms, Ms, Ha, Ms, Xu, Xu, Xu, Xu, Xu, Uh, Ww^Es, Uh, Ww^Es, Wwr^Es, Uu, Uu^Vu, Uu, Uh, Xu, Xu, Xu, Xu, Xu, Xu, Xu, Xu, Xu, Xu, Xu, Xu, Xu
Qxu, Qxu, Ha, Ha, Aa^Fda, Ms, Rb, Ha, Ha, Qxu, Ms, Ms, Ms, Ms, Ms, Ms, Ms, Xu, Ms, Xu, Xu, Wwr^Es, Wwr^Es, Ww, Uh, Uu, Uh, Uu, Rb, Xu, Ms, Ms, Xu, Xu, Xu, Xu, Xu, Xu, Xu, Xu, Xu, Xu, Xu
Ha^Fda, Ha, Ha^Fda, Aa, Rb, Rb, Aa^Fda, Ha, Ha, Ha, Ms, Ms, Ms, Ms, Ms, Ms, Ms, Qxu, Ms, Ms, Wwr, Wwr^Es, Wwr, Xu, Xu, Ur^Qov, Xu, Xu, Ms, Rb, Rb, Ms, Qxu, Xu, Ms, Xu, Xu, Xu, Xu, Xu, Xu, Xu, Xu
Ha^Fda, Ha^Fda, Ha^Fda, Aa^Fda, Rb, Aa, Aa^Fda, Ha, Ms, Ms, Ms, Ms, Ms, Ms, Ms, Ms, Ha, Qxu, Ha, Wwr, Wo, Wwr, Ha, Xu, Xu, Xu, Xu, Ms, Ms, Rb, Rb, Qxu, Aa, Qxu, Ha, Ms, Ms, Xu, Xu, Xu, Xu, Xu, Xu
Aa^Fda, Ha^Fda, Aa^Fda, Aa^Fda, Rb, Aa^Fda, Aa^Fda, Ha^Fda, Aa^Fda, Ms, Ms, Ms, Ms, Ms, Ms, Ms, Ha, Ha, Wwr, Wwr, Wo, Rb, Ha^Voa, Ms, Ms, Xu, Ms, Qxu, Qxu, Rb, Rb, Rb, Aa, Ms, Ha, Ms, Ms, Ms, Xu, Xu, Xu, Xu, Xu
Aa^Fda, Ha^Fda, Aa^Fda, Aa, Aa^Fda, Rb, Aa^Fda, Aa^Fda, Ms, Ms, Ms, Ms, Ms, Ha, Ms, Ms^Vca, Ms, Ai, Wwr^Es, Ww^Es, Rb, Rb, Ha, Ms, Ms, Ms, Ms, Ms, Ha, Aa, Ms, Rb, Rb, Ha, Ms, Ha, Ms, Ms, Ms, Xu, Xu, Xu, Xu
Aa^Fda, Aa^Fma, Aa^Fda, Aa^Fda, Rb, Rb, Aa, Aa^Fda, Ms, Ms, Ms, Ms, Ha, Ha, Ha, Ms, Rb, Ai, Wwr^Es, Wwr^Es, Ai, Ha, Ms, Ms, Ms, Ms, Ms, Ms, Ha, Ha, Ms, Rb, Rb, Ms, Ms, Ms, Qxu, Ms, Ms, Ms, Ms, Xu, Xu
Rb, Rb, Rb, Rb, Cea, Rb, Rb, Ha, Ms, Ms, Ms, Ms, Ms, Ha, Rb, Rb, Wo, Wo, Ww^Es, Wwr^Es, Rb, Ms, Ms, Ms, Ms, Ms, Ms, Ha, Ms, Ms, Ms^Voa, Ms, Rb, Rb, Aa, Qxu, Ai, Ms, Ms, Ms, Ms, Xu, Xu
Ms, Rb, Ha, Cea^Esa, 3 Kea, Cea, Rb, Ms, Ms, Ms, Rb, Ms, Ms, Ms, Rb, Ww, Wo^Es, Ww^Es, Ha, Rb, Ms, Ha, Ha, Ha, Ms, Ms, Ms, Ms, Ha, Ms, Ms, Ms, Rb, Rb, Aa, Ai, Ms, Aa, Ms, Ms, Ms, Ms, Ms
Ms, Ms, Ha, Cea^Esa, Cea^Esa, Cea, Ha, Rb, Rb, Rb, Ms^Voa, Rb, Rb, Ms, Rb, Wwr, Ww, Ai, Ha, Ms, Ms, Ms, Ms, Ms, Ms, Ms, Ms, Ha, Ms, Ha, Ha, Rb, Rb, Ms, Ha, Aa, Ms, Ms, Ms, Ms, Ms, Ms, Ms
Ms, Ms^Qhh, Ms, Ha, Ms, Ha, Ms, Ms, Ha, Ms, Ms, Ms, Ms, Rb, Ww^Es, Ww^Bw\r, Rb, Ai, Ms^Voa, Ha, Ms, Ha, Ha, Ms, Ms, Ms, Ms, Ms, Ms, Ha, Ha, Ms, Rb, Rb, Ha, Ms, Ms, Ms, Ms, Ms, Ms, Ms, Ms
Ms, Ms^Qhh, Ms^Qhh, Ms, Ms, Qxu, Ha, Ha, Ms, Ms, Ms, Ms, Ai, Ai, Wo^Es, Wwr^Es, Rb, Ms, Ms, Ms, Rb, Rb, Rb, Ms, Ms, Ms, Ha, Ha^Vca, Ms, Ms, Rb, Rb, Rb, Ha, Ms, Ms^Vca, Ms, Ms, Ms, Ms, Ms, Ms, Ms
Ms, Ms, Ms, Ms, Qxu, Qxu, Qxu, Ha, Ha, Ms, Ms, Ms, Ww, Ww^Es, Wo^Es, Wwr, Ms, Rb, Rb, Rb, Ms, Ha, Ha, Rb, Rb, Rb, Rb, Rb, Rb, Ms, Rb, Rb, Aa, Aa, Ms, Ms, Ms, Ms, Ms, Ms, Ms, Ms, Ms
Ms, Ms, Ms, Ms, Ms, Ms, Ms, Ms, Ha, Ha, Wo, Wwr, Ww, Wo, Rb, Rb, Ms, Ms, Ms, Ms, Ms, Ha, Ms, Ms, Ha, Ha, Ha, Rb, Aa^Fpa, Rb, Rb, Rb, Aa, Qxu, Ms, Ms, Ms, Ms, Ms, Ms, Ms, Ms, Ms
Ms, Ms, Ms, Ms, Ms, Ms, Ms, Ms, Ai, Ai, Wo, Wwr^Es, Ms, Ai, Rb, Ms, Ms, Ms, Ms, Ms, Ms, Ms, Ms, Ms, Ms, Ms, Ms, Aa^Fpa, Rb, Rb, Aa, Ms, Qxu, Qxu, Ms, Ms, Ms, Ms, Qxu, Ms, Ms, Ms, Ms
Ms, Ha, Ha, Ms, Ms, Ms, Ms, Ms, Wo, Wo, Wwr, Ww^Es, Ms, Rb, Ms, Ms, Ms, Ms, Ms, Ms, Ms, Qxu, Qxu, Qxu, Ha, Ms, Aa^Fpa, Aa^Fpa, Rb, Rb, Rb, Ms, Ms, Ha, Ha, Ha, Ms, Qxu, Ms, Ms, Ms, Ms, Ms
Ms, Ms, Ha, Ha, Ai, Wog, Wo, Wo, Wo, Wo, Ms, Ms, Aa, Ms^Voa, Aa, Ms, Ha, Ha, Ha, Ms, Ha^Voa, Ha, Ha, Ha^Fpa, Aa^Fpa, Aa^Fpa, Aa^Esa, Aa^Fpa, Aa, Rb, Rb, Ha, Ha, Ha, Ha, Qxu, Qxu, Qxu, Ms, Ms, Ms, Ms, Ms
Ms, Ms, Ms, Ha, Wo, Wo, Wo, Wo, Ai, Aa^Fpa, Ms, Ms, Aa, Aa, Ms, Ms, Ms, Qxu, Ha, Ha, Ha^Fpa, Ha, Aa^Fpa, Aa, Aa^Fma, Aa^Fma, Ha, Aa^Fma, Aa^Fpa, Rb, Rb, Ms, Ms^Voa, Ms, Ha, Qxu, Ms, Qxu, Ms, Ms, Ms, Ms, Ms
Wo, Wo, Wo, Wo, Wo, Wo, Ms, Ai, Aa^Fpa, Aa^Fpa, Aa^Edb, Aa^Edb, Aa^Edb, Aa^Fpa, Ha^Fpa, Ms, Ms, Qxu, Qxu, Ha^Fpa, Ha^Fpa, Ha^Fpa, Aa^Fma, Aa^Fma, Ha^Fma, Ha^Fpa, Aa^Fpa, Aa^Esa, Rb, Rb, Rb, Aa, Aa, Ms, Ha, Qxu, Ms, Ms, Ms, Ms, Ms, Ms, Ms
Wo, Wo, Wo, Wo, Ms, Ms, Ha, Ms, Ha^Fpa, Aa^Fpa, Aa^Fpa, Koa, Ha^Fpa, Ha^Fpa, Ms, Ms, Ms, Ms, Ms, Ha^Fma, Ha^Fpa, Aa^Fpa, Ha^Fpa, Aa, Aa^Feta, Ha^Fma, Ha^Fpa, Aa^Fma, Aa^Fma, Rb, Rb, Rb, Aa, Ha, Ha, Ms, Ha^Fma, Ms, Ms, Ms, Ms, Ms, Ms
Ai, Wog, Ai, Wog, Ms, Ms, Ms^Vca, Ha^Fpa, Ms, Ha^Fpa, Ms, Aa^Fpa, Ms, Ha^Fpa, Ms, Ms, Ms, Ms, Ms, Ha, Ha^Fma, Ha^Fpa, Ha^Fma, Ha^Fma, Aa^Esa, Ha^Fma, Ha^Fma, Aa^Fpa, Aa^Fpa, Aa^Fma, Rb, Rb, Rb, Aa, Aa, Ms, Aa^Fma, Ha^Fma, Ms, Ms, Ms, Ms, Ms
Ai, Ai, Ms, Ms, Ms, Ms, Ms, Ms, Ms, Ms, Ms, Ms, Ms, Ms, Ms, Ms^Vca, Ms, Ms, Ms, Ha, Ha^Fpa, Ha^Fma, Aa, Aa^Fma, Ha^Fpa, Ha, Ha^Fma, Ha^Fma, Aa^Fpa, Rb, Cea, Cea, Cea, Rb, Aa^Fpa, Aa^Fpa, Aa^Fma, Aa^Fpa, Aa^Fpa, Ms, Ms, Ms, Ms
Ms, Ms, Ms, Ms, Ms, Ms, Ms, Ms, Ms, Ms, Ms, Ms, Ms, Ms, Ms, Ms, Qxu, Ha, Ha, Ha^Fpa, Ha, Ha^Fpa, Ha^Fma, Aa^Fma, Aa^Fma, Ha^Fma, Aa^Fma, Aa^Fpa, Aa, Rb, Cea, 1 Kea, Cea, Rb, Aa^Fpa, Aa^Fma, Ha, Aa^Vca, Aa^Fma, Ms, Ms, Ms, Ms
Ms, Ms, Ms, Ms, Qxu, Ms, Ms, Ms, Ms, Ms, Ms, Ms, Ms, Ms, Ms, Qxu, Qxu, Ha, Qxu, Ha, Ha, Ha, Ha^Fpa, Ha^Fma, Aa^Fpa, Aa^Fma, Aa^Fpa, Aa^Esa, Aa^Fma, Rb, Rb, Cea, Rb, Rb, Aa^Fpa, Aa^Fpa, Ha, Ms, Ms, Ha, Ms, Ms, Ms
Qxu, Qxu, Qxu, Qxu, Qxu, Ms, Ms, Ms, Ms, Ms, Ms, Ms, Ms, Ms, Ms, Ms, Qxu, Qxu, Ms, Ha, Ha, Ha^Fpa, Ha^Fpa, Ha^Fpa, Ha^Fpa, Aa^Fma, Aa^Fpa, Aa^Fma, Aa^Fpa, Aa^Fpa, Aa^Fpa, Rb, Rb, Rb, Ms, Ms, Ms, Ms, Ms, Ms, Ms, Ms, Ms
Qxu, Qxu, Qxu, Qxu, Qxu, Ms, Ms, Ms, Ms, Ms, Ms, Ms, Ms, Ms, Qxu, Qxu, Qxu, Qxu, Qxu, Ms, Ms, Ha, Aa^Fma, Ha^Fpa, Ha, Ha, Ha, Ha^Fpa, Aa^Fpa, Aa^Fpa, Aa^Fpa, Rb, Ur, Ms, Ms, Ms, Ms, Ms, Ms, Ms, Ms, Ms, Ha
