Ms^Qhh, Ms^Qhh, Ms^Qhh, Ms^Qhh, Ms^Xm, Ms^Qhh, Ms^Qhh, Ms^Qhh, Ms^Qhh, Ms^Qhh, Ms^Qhh, Hhd, Ms^Qhh, Ms^Qhh, Ha^_mh, Ha^Qhh, Ms^Qhh, Hhd, Ms^Qhh, Ms^Qhh, Ms^Qhh, Ms^Qhh, Ms^Qhh, Ms^Qhh, Ms^Qhh, Hhd^Qhhf, Ha^Qhhf, Ha^Qhh, Aa^Qhhf, Ms^Qhh, Ms^Qhh, Ms^Qhh, Ms^Qhh, Gd, Ms^Qhh, Gd, Ms^Qhh, Gd, Ha^Qhh, Ai, Wwrg, Aa, Aa^Fpa, Aa^Fpa, Ms^Qhhf, Ms^Qhh, Ms^Qhh, Gd, Ms^Qhh, Ms^Qhh
Ms^Qhh, Ms^Qhh, Ms^Qhh, Ms^Xm, Ms^Qhh, Ms^Qhh, Ms^Qhh, Ms^Qhh, Ms^Qhh, Ms^Qhh, Ha^Qhh, Ms^Qhh, Ha^Qhh, Ha^Qhh, Ha^Qhh, Ha^Qhh, Ms^Qhh, Ms^Qhh, Ms^Qhh, Mm, Ms^Qhh, Ms^Qhh, Ms^Xm, Ms^Qhh, Ms^Qhh, Ha^Qhhf, Ha^Qhhf, Aa^Qhhf, Aa^Fpa, Aa^Qhhf, Aa^Qhhf, Ha^Qhhf, Ha^Qhh, Ha^Qhh, Ha^Qhh, Ms^Qhh, Ms^Qhh, Ms^Qhh, Ha^Qhh, Ai, Wog, Aa, Ha^Qhhf, Aa^Fpa, Ha^Qhhf, Ms^Qhh, Ms^Qhh, Ms^Qhh, Aa^Qhhf, Aa^Qhhf
Ms^Qhh, Ms^Qhh, Ms^Qhh, Ms^Qhh, Ms^Qhh, Ms^Qhh, Ha^Qhh, Ha^Qhh, Ha^Qhh, Ms^Qhh, Ha^Qhh, Ha^Qhh, Ha^Qhh, Ha^Qhh, Ms^Qhh, Ha^Qhh, Ms^Qhh, Ms^Qhh, Ms^Qhh, Ms^Qhh, Ms^Qhh, Ms^Xm, Ms^Xm, Ms^Qhh, Ms^Qhh, Ms^Qhh, Ms^Qhh, Ms^Qhh, Ms^Qhh, Ms^Qhh, Ms^Qhh, Ha^Qhhf, Ha^Qhh, Wwrg^Qhh, Wog^Qhh, Ha^Qhh, Ha^Qhh, Ha^Qhh, Aa, Wog, Ai, Ha^Qhh, Ha^Qhh, Ms^Qhh, Ms^Qhh, Ha^Qhhf, Ha^Qhhf, Aa^Qhhf, Aa^Fpa, Aa^Fpa
Ms^Qhh, Ms^Qhh, Ms^Qhh, Ha^Qhh, Ms^Qhh, Ms^Qhh, Ms^Qhh, Ha^Qhh, Ha^Qhh, Ha^Qhh, Ms^Qhh, Ha^Qhh, Ms^Qhh, Ms^Qhh, Ms^Qhh, Ms^Qhh, Mm^Qhh, Mm^Qhh, Mm^Qhh, Mm^Qhh, Mm^Qhh, Mm^Qhh, Mm^Qhh, Ms^Xm, Ms^Xm, Ha^Qhh, Ha^Qhh, Ms^Qhh, Ha^Qhh, Ms^Qhh, Ms^Qhh, Ms^Qhh, Ms^Qhh, Ha^Qhh, Wog^Qhh, Ha^Qhh, Ha^Qhh, Ha^Qhh, Wwg, Wog, Aa, Ha^Qhh, Ha^Qhh, Ha^Qhh, Ha^Qhh, Ms^Qhh, Ha^Qhh, Ha^Qhhf, Ms^Qhh, Ha^Qhh
Ha^Qhh, Ha^Qhh, Ha^Qhh, Ms^Qhh, Ms^Qhh, Ms^Qhh, Ha^Qhh, Ha^Qhh, Ha^Qhh, Ha^Qhh, Ha^Qhh, Ha^Qhh, Ms^Qhh, Ms^Qhh, Ms^Xm, Ms^Xm, Mm^Qhh, Mv, Cte, Mm^Qhh, Cte, Mv, Mm^Qhh, Mm^Qhh, Ms^Qhh, Ms^Qhh, Ha^Qhh, Ha^Qhh, Wog^Qhh, Ha^Qhh, Ha^Qhh, Ha^Qhh, Ha^Qhh, Ha^Qhh, Ha^Qhh, Wog, Wog, Wog, Ai, Wog, Wog, Ha^Qhh, Wog^Qhh, Wwrg^Qhh, Ms^Qhh, Ha^Qhh, Ms^Qhh, Ms^_mh, Ms^Qhh, Ms^Qhh
Ms^Qhh, Ha^Qhh, Ms^Qhh, Ms^Qhh, Ms^Qhh, Ms^Qhh, Ha^Qhh, Ha^Qhh, Ms^Qhh, Ha^Qhh, Ms^Qhh, Ms^Qhh, Mm^Qhh, Ms^Qhh, Mm^Qhh, Mm^Qhh, Cte, Cte, Cf, Cte, Cf, Cte, Cte, Mm^Qhh, Mm^Qhh, Ms^Qhh, Mm^Qhh, Wwrg^Qhh, Ha^Qhh, Wog^Qhh, Ha^Qhh, Ha^Qhh, Ha^Qhh, Aa, Wog, Ai, Aa, Ha^Qhh, Ha^Qhh, Aa, Ha^Qhh, Wog^Qhh, Ha^Qhh, Ms^Qhh, Ms^Qhh, Ms^Qhh, Ms^Qhh, Ms^Qhh, Ms^Qhh, Ms^Qhh
Ms^Qhh, Ms^Qhh, Ms^Qhh, Ms^Qhh, Ha^Qhh, Ha^Qhh, Ha^Qhh, Ha^Qhh, Ms^Qhh, Ms^Qhh, Mm^Qhh, Mm^Qhh, Mm^Qhh, Mm^Qhh, Mm^Qhh, Mv, Cte, Ql, Cf, 4 Cf^Kov, Cf, Ql, Cte, Mv, Mm^Qhh, Ms^Qhh, Mm^Qhh, Mm^Qhh, Ha^Qhh, Wog, Wog, Wwg, Wog, Wog, Wog, Ai, Aa, Aa, Ms^Qhh, Ha^Qhh, Ms^Qhh, Ha^Qhh, Ms^Qhh, Ms^Qhh, Ms^Qhh, Ms^Qhh, Ms^Qhh, Ms^Qhh, Ha^Qhh, Ms^Qhh
Ms^Qhh, Ms^Qhh, Ha^Qhh, Ha^Qhh, Ha^Qhh, Ms^Qhh, Ms^Qhh, Ha^Qhh, Mm^Qhh, Ms^Qhh, Ha^Qhh, Mm^_mh, Ha^Qhh, Mm^Qhh, Mm^Qhh, Mm^Qhh, Hhd^Qhh, Cte, Cte, Cte, Cte, Cte, Hhd^Qhh, Mm^Qhh, Ms^Qhh, Mm^Qhh, Mm^Qhh, Mm^Qhh, Mm^Qhh, Ha^Qhh, Ha^Qhh, Wog, Ai, Wwg, Ha^Qhh, Ha^Qhh, Ms^Qhh, Ms^Qhh, Cte, Ms^Qhh, Ms^Qhh, Ms^Xm, Ms^Qhh, Ms^Qhh, Ha^Qhh, Ms^Qhh, Ms^Qhh, Aa^Qhhf, Aa^Qhhf, Ha^Qhh
Ha^Qhh, Ha^Qhh, Ha^Qhh, Aa, Ha^Qhh, Ms^Qhh, Ha^Qhh, Mm^Qhh, Mm^Qhh, Ms^Qhh, Ha^Qhh, Ha^Qhh, Ha^Qhh, Mm^Qhh, Mm^Qhh, Hhd^Qhh, Mm^Qhh, Mv^Qhh, Mm^Qhh, Hhd^Qhh, Mm^Qhh, Mv, Mm^Qhh, Hhd^Qhh, Mm^Qhh, Ms^Qhh, Ms^Qhh, Hhd^Qhh, Hhd^Qhh, Ha^Qhh, Wog, Wog, Aa^Esa, Ha^Qhh, Ha^Qhh, Ms^Qhh, Cte, Cte, 5 Kte, Cte, Ms^Xm, Ms^Xm, Ms^Qhh, Aa^Qhhf, Aa^Qhhf, Ms^Qhh, Aa^Qhhf, Aa^Fpa, Ms^Qhh, Ms^Qhh
Hhd^Qhh, Ha^Qhh, Aa, Aa, Ha^Qhh, Ha^Qhh, Ha^Qhh, Mm^Qhh, Mm^Qhh, Ha^Qhh, Ha^Qhh, Ha^Qhh, Hhd^Qhh, Mm^Qhh, Hhd^Qhh, Hhd^Qhh, Mm^Qhh, Mm^Qhh, Mm^Qhh, Hhd^Qhh, Mm^Qhh, Mm^Qhh, Mm^Qhh, Hhd^Qhh, Mm^Qhh, Mm^Qhh, Mm^Qhh, Mm^Qhh, Hhd^Qhh, Hhd^Qhh, Wog, Ai, Ha^Qhh, Ha^Qhh, Mm^Qhh, Mm^Qhh, Mm^Qhh, Cte, Chr, Chr, Ms^Qhh, Ms^Qhh, Ha^Qhhf, Aa^Fpa, Ms^Qhhf, Ha^Qhh, Ms^Qhh, Ha^Qhh, Ms^Qhh, Ms^Qhh
Hhd^Qhh, Ha^Qhh, Aa, Aa, Hhd^Qhh, Hhd^Qhh, Hhd^Qhh, Mm^Qhh, Hhd^Qhh, Hhd^Qhh, Hhd^Qhh, Aa, Aa, Hhd^Qhh, Hhd^Qhh, Hhd^Qhh, Hhd^Qhh, Mm^Qhh, Hhd^Qhh, Hhd^Qhh, Hhd^Qhh, Mm^Qhh, Hhd^Qhh, Hhd^Qhh, Hhd^Qhh, Mm^Qhh, Mm^Qhh, Hhd^Qhh, Hhd^Qhh, Wog, Wog, Wwg, Gll^Fp, Hhd^Qhh, Hhd^Qhh, Mm^Qhh, Mm^Qhh, Mm^Qhh, Mm^Qhh, Chr, Ms^Qhh, Ha^Qhh, Ha^Qhh, Ms^Qhh, Ha^Qhh, Ms^Qhh, Ms^Qhh, Ms^Qhh, Ha^Qhh, Ha^Qhh
Hhd^Qhh, Ha^Qhh, Hhd^Qhh, Aa, Aa, Aa, Hhd^Qhh, Hhd^Qhh, Hhd^Qhh, Gd^Es, Gd, Aa, Aa, Hhd^Qhh, Hhd^Qhh, Hhd^Qhh, Hhd^Qhh, Hhd^Qhh, Gd, Hhd^Qhh, Gd^Es, Hhd^Qhh, Hhd^Qhh, Hhd^Qhh, Hhd^Qhh, Mm^Qhh, Hhd^Qhh, Hhd^Qhh, Ai, Wwrg, Gll^Fp, Gll^Fp, Hhd^Qhhf, Hhd^Qhh, Hhd^Qhh, Hhd^Qhh, Mm^Qhh, Mm^Qhh, Mm^Qhh, Hhd^Qhh, Hhd^Qhh, Ha^Qhh, Hhd^Qhh, Ha^Qhh, Ha^Qhh, Ha^Qhh, Ha^Qhh, Ha^Qhh, Aa, Ha^Qhh
Hhd^Qhh, Hhd^Qhh, Hhd^Qhh, Hhd^Qhh, Hhd^Qhh, Aa, Aa, Hhd^Qhh, Hhd^Qhh, Gd, Gd, Aa, Gd, Aa, Gd, Gd^Es, Gd, Gd, Gd, Gd, Gll^Fp, Hhd^Qhh, Gll^Fp, Hhd^Qhh, Hhd^Qhh, Hhd^Qhh, Hhd^Qhh, Gd, Hhd, Wwg, Ai, Gll^Fmw, Hhd^Qhhf, Hhd^Qhhf, Gd^Fp, Hhd^Qhh, Hhd^Qhh, Hhd^Qhh, Hhd^Qhh, Hhd^Qhh, Hhd^Qhh, Hhd^Qhh, Hhd^Qhh, Ha^Qhh, Ha^Qhh, Aa, Aa, Ha^Qhh, Aa, Aa
Mm^Qhh, Hhd^Qhh, Hhd^Qhh, Hhd^Qhh, Hhd^Qhh, Aa, Aa, Aa, Gd, Gd^Es, Gd, Gd, Gd, Gd, Gd, Gd, Re^Vo, Re, Re^Fp, Re^Fp, Re^Qhhf, Re^Qhhf, Re^Fp, Hhd^Qhh, Re^Fp, Hhd^Qhh, Re, Gd, Re, Wwg, Wwg, Gll^Fmw, Gd^Fp, Gll^Fmf, Gll^Fmw, Hhd^Qhh, Re^Fp, Re^Fp, Hhd^Qhhf, Hhd^Qhh, Gll^Fp, Hhd^Qhh, Hhd^Qhh, Aa, Aa, Aa, Aa, Aa, Aa, Aa
Mm^Qhh, Mm^Qhh, Hhd^Qhh, Hhd^Qhh, Hhd^Qhh, Aa, Aa, Aa, Gd, Gd, Gd, Aa, Aa, Gd, Hhd^Qhh, Re^Edt, Re^Edt, Gd, Gd^Fp, Hhd^Qhh, Hhd^Qhh, Hhd^Qhh, Hhd^Qhh, Re^Fmf, Hhd^Qhh, Re^Fmf, Re^Fp, Re, Wwg, Chr, Wwg^Bw\r, Gll, Gll, Gll^Fmw, Gll^Fp, Gll^Fp, Hhd^Qhh, Gll^Fp, Gs^Vc, Gd^Fp, Hhd^Qhh, Hhd^Qhh, Hhd^Qhh, Hhd^Qhh, Hhd^Qhh, Aa, Aa, Aa, Aa, Aa
Mm^Qhh, Mm^Qhh, Wwrg, Hhd^Qhh, Hhd^Qhh, Hhd^Qhh, Gd^Es, Gd, Re, Gd, Rb, Aa, Gd^Es, Aa, Hhd^Qhh, Rb, Re, Gd, Hhd^Qhh, Gd^Qhhf, Mm^Qhh, Mm^Qhh, Wwrg, Hhd^Qhh, Hhd^Qhh, Re^Fp, Gd^Fp, Ai, Gd, Wwg, Gd, Chr, Rb^Edb, Gll^Fp, Re^Vhr, Hhd^Qhh, Hhd^Qhh, Hhd^Qhhf, Gd^Fp, Gd^Fp, Gll^Fp, Gll^Fp, Hhd^Qhh, Hhd^Qhh, Hhd^Qhh, Aa, Gd^Es, Aa, Gd, Aa
Gd, Wwf, Gd, Hhd^Qhh, Hhd^Qhh, Gd, Gd, Gd, Re, Re^Vo, Re^Edt, Gd, Hhd^Qhh, Hhd^Qhh, Hhd^Qhh, Hhd^Qhh, Re, Re, Hhd^Qhh, Hhd^Qhh, Hhd^Qhh, Hhd^Qhh, Gd^Fp, Wwg, Gd^Fp, Gd^Fp, Wwrg, Ai, Gd, Gd, Hhd^Qhh, Rb, Rb^Edb, Rb^Edb, Rb, Rb, Rb^Edb, Hhd^Qhh, Hhd^Qhh, Hhd^Qhhf, Gll^Fp, Gll^Fp, Gll^Fmw, Hhd^Qhh, Gd^Es, Hhd^Qhh, Gd, Gd, Gll, Gd
Gd, Wwf, Wog, Gd, Gd, Gd, Re, Re, Gd, Re^Edt, Rb, Gd, Hhd^Qhh, Gd^Es, Rb, Re, Re^Vo, Gd, Gd, Hhd^Qhh, Gd, Gd^Fp, Wog, Wog, Wog, Wog, Gd, Gd, Gd^Es, Hhd^Qhh, Hhd^Qhh, Re, Rb^Vhr, Rb, Re^Dr, Rb^Edb, Rb^Edb, Re^Vhr, Hhd^Qhh, Hhd^Qhh, Hhd^Fp, Gll^Fp, Gll^Fp, Hhd^Qhh, Gd, Gd, Gll, 6 Gll, Gll^Fmf, Gll
Wog, Wog, Wog, Wwg, Wog, Wog, Wog^Bp|, Wog^Bp|, Wog, Gd, Gd, Gd, Gd^Es, Gd, Gd, Rb^Edt, Re^Edt, Gd, Gd, Hhd^Qhh, Gd, Wwg, Gd, Gd, Gd, Gd^Es, Hhd^Qhh, Hhd^Qhh, Hhd^Qhh, Hhd^Qhh, Hhd^Qhh, Re^Edb, Hhd^Qhh, Rb^Edb, Gll^Fp, Chr, Re^Fp, Rb, Hhd^Qhh, Gd^Es, Gll, Gll^Fp, Gll, Gll^Fp, Gll, Gll, Gll, Gd^Fp, Re^Fp, Gll^Fmw
Wwg, Wog, Ai, Wog, Ai, Wwg, Re, Re, Wog, Wwg, Gd, Gd, Gd, Gd, Gd, Re^Edt, Gd, Re, Re, Gd, Wwg, Ai, Gll, Hhd^Fp, Hhd^Qhh, Hhd^Qhh, Mm^Qhh, Mm^Qhh, Mm^Qhh, Mm^Qhh, Mm^Qhh, Mm^Qhh, Hhd^Qhh, Gd^Fp, Gll^Fp, Gll^Fp, Gll^Fp, Rb, Re, Gd, Gd, Gll, Gd, Gd, Gll, Gll^Fp, Gd^Fp, Gll^Fp, Gd^Fp, Re^Fp
Ai, Ai, Gd, Ai, Rb^Vct, Rb^Edt, Rb^Edt, Gd, Gd, Wwg, Wwg, Gd, Gd, Gd, Gd^Es, Gd, Gd, Gd, Wog, Wog^Bp\, Re, Gd, Gd^Fp, Gd^Fp, Hhd^Fp, Hhd^Qhh, Hhd^Fp, Hhd^Qhh, Mm^Qhh, Mm^Qhh, Hhd^Qhh, Wwrg, Wwg, Gll, Gll, Gll^Fp, Gll, Gll, Re, Gd, Gd, Gd, Gd^Es, Gd, Gd, Gll, Gd^Fp, Gd^Fp, Gd^Fp, Gll^Fmw
Gd, Gd, Gd, Rb^Vct, Co^Qhh, Co, Co, Rb^Edt, Gd, Ai, Wog, Ai, Gd, Gd, Gd, Gd^Es, Gd, Gd, Wwg, Gd, Rb, Gd, Rb^Edt, Gll^Es, Gd^Fp, Gll^Fp, Gd^Fp, Hhd^Qhh, Hhd^Qhh, Hhd^Qhh, Hhd^Fp, Hhd^Qhh, Wwg, Gll^Fp, Gll, Gll, Cer^Vo, Gd, Gd, Gd, Gd, Gd^Es, Gd^Es, Gd, Gd, Gll^Fmw, Gd^Fp, Gd^Fp, Gd^Fp, Gd^Fp
Gd, Gd, Gd, Rb^Vct, Co, Co, Ko, Rb^Edt, Rb^Edt, Gd, Re, Wog^Bp/, Wog, Gd, Gd, Gd, Gd, Wwg, Gd, Gd^Edt, Rb^Vo, Rb^Edt, Rb^Edt, Rb^Vo, Gll, Re^Fp, Hhd^Qhh, Hhd^Fp, Hhd^Qhh, Hhd^Qhh, Gll^Fp, Hhd^Fp, Gd^Fp, Wwg, Gd, Gd, Re, Re^Edb, Gd, Gd, Gd, Gd, Gd, Gd, Gd, Gll, Gd, Hhd^Qhh, Hhd^Qhh, Gd^Fmf
Gd, Gd, Gd, Rb^Edt, Rb^Edt, Ko, Ko, Co^Qhh, Co, Rb^Edt, Gd, Wog, Wog, Wog^Bp|, Wog, Wwg, Wog, Wwg, Wwg, Gd, Gd, Rb, Re, Rb^Edt, Gd, Gll, Gd, Gd^Es, Gd, Gll^Fp, Cer^Vo, Gll^Fp, Gd^Fp, Wwg, Gd, Gd, Gd, Gd, Re^Edb, Gd^Edb, Gd, Gd, Gd, Gd^Es, Gd, Gd, Hhd^Qhh, Hhd^Qhh, Mm^Qhh, Hhd^Qhh
Hhd^Qhh, Gd, Gd, Gd, Gd, Rb^Edt, Co, Co^Qhh, Co, Rb^Vct, Re^Edt, Gd, Re, Re, Gd, Wog, Gd, Wog, Wwg, Wwg, Wwg, Gd, Wwg^Bp|, Gd, Gd, Gd, Gd, Gd, Gd, Gd^Edt, Gd^Edt, Gd^Fp, Wwf, Wwg, Gd, Gd, Gd, Gd, Re, Re^Vo, Gd, Gd, Gd^Es, Gd, Gd, Gd^Es, Hhd^Qhh, Hhd^Qhh, Mm^Qhh, Mm^Qhh
Hhd^Qhh, Gd^Es, Hhd^Qhh, Gd^Es, Gd, Rb^Edt, Rb^Edt, Co, Rb^Vct, Rb^Vct, Rb^Edt, Re, Gd, Gd, Gd, Gd, Re^Vo, Gd, Gd, Gd, Gd, Wwg^Bp|, Rb, Wwg^Bp|, Wwg, Wwg, Ai, Ai, Ai, Wwg, Wwg, Wwf, Gd, Gd, Gd, Re^Edb, Re^Edb, Gd, Gd, Gd, Gd, Hhd^Qhh, Hhd^Qhh, Hhd^Qhh, Hhd^Qhh, Gd, Gd, Gd, Mm^Qhh, Hhd^Qhh
Hhd^Qhh, Hhd^Qhh, Md^Qhh, Hhd^Qhh, Hhd^Qhh, Gd, Gd, Rb^Edt, Gd, Re^Edt, Rb^Edt, Re^Edt, Re^Edt, Gd, Gd, Gd^Es, Gd, Gd, Rb^Edb, Rb, Rb^Edb, Rb, Rb^Edt, Rb, Gd, Gd, Gd, Gd, Gd, Gd, Gd, Gd, Gd, Gd, Gd^Edb, Re^Vo, Gd, Gd, Rb^Edt, Rb^Edt, Rb^Edt, Hhd^Qhh, Co, Hhd^Qhh, Hhd^Qhh, Gd, Gd, Hhd^Qhh, Hhd^Qhh, Hhd^Qhh
Hhd^Qhh, Md^Qhh, Hhd^Qhh, Md^Qhh, Hhd^Qhh, Gd^Es, Hhd^Qhh, Gd, Gd, Gd, Re^Edt, Rb^Edt, Rb^Edt, Rb^Edt, Rb^Edt, Re^Edt, Rb^Edt, Rb^Edt, Rb^Vct, Rb^Vct, Rb^Vct, Rb^Edb, Rb, Rb^Edt, Rb^Edt, Gd, Rb^Edt, Gd, Gd, Gd, Gd, Gd, Gd, Gd, Gd, Gd, Re^Edt, Rb^Edt, Co, Co, Ko, Ko, Co, Co, Rb^Vct, Hhd^Qhh, Gd, Gd^Es, Hhd^Qhh, Hhd^Qhh
Hhd^Qhh, Hhd^Qhh, Hhd^Qhh, Md^Qhh, Md^Qhh, Hhd^Qhh, Hhd^Qhh, Gd^Es, Hhd^Qhh, Gd, Gd, Re^Edt, Gd, Re^Edt, Rb^Edt, Rb^Edt, Rb^Edt, Rb, Rb, Rb, Rb, Rb, Co^Edt, Rb, Rb, Rb^Edt, Rb, Rb^Edt, Gd, Gd, Gd, Gd, Gd, Re, Gd, Gd, Rb^Edt, Rb^Edt, Co, Co, Co, Ko, Co, Co, Rb^Vct, Hhd^Qhh, Gd, Gd, Gd^Es, Gd
Hhd^Qhh, Hhd^Qhh, Hhd^Qhh, Md^Qhh, Md^Qhh, Hhd^Qhh, Hhd^Qhh, Hhd^Qhh, Gd^Es, Gd, Gd, Gd, Gd, Gd, Gd, Rb^Edt, Rb^Edt, Rb^Edt, Co, Co, Co, Co^Edt, Ko, Co^Edt, Co^Edt, Rb^Edt, Rb, Rb^Vct, Rb^Vct, Gd, Gd^Vo, Re^Edb, Gd, Gd, Re^Edt, Rb^Edt, Re^Edt, Rb^Edt, Rb^Vct, Co, Rb^Vct, Rb^Edt, Rb^Edt, Rb^Vct, Rb, Gd, Re^Edt, Gd, Gd, Gd
Gd, Hhd^Qhh, Gd^Es, Hhd^Qhh, Hhd^Qhh, Md^Qhh, Hhd^Qhh, Hhd^Qhh, Hhd^Qhh, Hhd^Qhh, Gd^Es, Gd, Gd, Gd, Gd, Rb^Edt, Rb^Vct, Rb, Co, Co^Ecf, Co^Qhh, Ko, 3 Ko, Ko, Co, Co, Co, Rb, Rb^Vct, Rb^Edt, Re, Gd, Re, Gd, Rb^Edt, Rb^Edt, Gd, Gd, Gd, Rb^Vct, Gll, Rb^Edt, Rb^Edt, Re^Edt, Rb^Edt, Rb^Edt, Rb^Edt, Re, Gd, Gd
Gd, Gd, Gd, Gd, Hhd^Qhh, Hhd^Qhh, Hhd^Qhh, Md^Qhh, Md^Qhh, Hhd^Qhh, Hhd^Qhh, Hhd^Qhh, Gd^Es, Gd, Re, Rb^Edt, Rb^Vct, Rb, Rb, Co, Co^Edt, Ko, Ko, Ko, Co, Co^Ecf, Co, Rb, Rb^Edt, Rb^Edt, Rb^Edt, Rb^Edt, Rb^Edt, Rb^Edt, Re^Edt, Re^Edt, Gll^Fdf, Gll, Gll^Fdf, Gll, Gll, Gd^Fdf, Gll^Fdf, Rb^Edt, Gll^Fdf, Gd^Fdf, Gll^Fdf, Rb^Edt, Re^Edt, Gd
Rb^Edt, Re, Rb^Edt, Re, Re^Edt, Re^Vo, Re^Edt, Hhd^Qhh, Hhd^Qhh, Hhd^Qhh, Hhd^Qhh, Hhd^Qhh, Hhd^Qhh, Re, Rb^Edt, Rb^Edt, Rb^Edt, Rb^Vct, Rb^Edt, Rb^Edt, Rb, Co^Edt, Co^Edt, Co^Edt, Rb, Co, Rb, Rb^Edt, Rb^Edt, Re, Gd, Gd, Gd, Gll, Gll, Gll^Fmf, Gd^Fdf, Gd^Fdf, Rb^Fdf, Gll, Gll^Fdf, Gd^Fdf, Gd^Fdf, Rb^Fdf, Gll^Fdf, Gd^Fdf, Gll^Fdw, Rb^Edt, Rb^Edt, Rb^Edt
Re, Rb^Edt, Re, Rb^Edt, Rb^Edt, Rb^Edt, Rb^Edt, Re, Rb^Edt, Re, Rb^Edt, Re, Co, Re, Rb^Edt, Re, Gd, Rb^Edt, Gd, Rb^Edt, Rb, Rb, Rb, Rb, Rb^Vct, Rb, Rb^Vct, Rb, Rb^Edt, Gd, Gd^Fdf, Gd, Gll, Gll^Fdf, Gll^Fdf, Gll^Fdf, Gd^Fdf, Gd^Fdf, Gll^Feth, Gll, Gll^Fdf, Gd^Fdf, Gll^Fdf, Gll^Fdf, Gll^Fmf, Gd^Fdf, Gd^Fdf, Gd^Fdf, Gll^Fdf, Gll^Fdf
Re, Re, Hhd^Qhh, Re, Hhd^Qhh, Re, Re, Rb^Edt, Re^Edt, Rb^Edt, Re^Edt, Rb^Edt, Rb^Edt, Rb^_mh, Re, Hhd^Qhh, Hhd^Qhh, Gd, Gd, Gd^Em, Gd, Rb^Edt, Rb^Edt, Rb^Edt, Rb^Edt, Rb^Vct, Rb^Edt, Rb^Edt, Gd^Fdf, Gll, Gll^Fdw, Gll^Fdf, Gd^Fdf, Gll^Fdf, Gll^Fmf, Gll^Fdf, Gll^Fdf, 2 Gll^Em, Gd, 1 Gll, Gll^Fdf, Gll^Fmf, Gll^Fdw, Gd^Fdf, Gll^Fdf, Gll^Fdf, Gll^Fmf, Gll^Fdw, Gll^Fdw, Gd^Fdf
Hhd^Qhh, Hhd^Qhh, Md^Qhh, Hhd^Qhh, Hhd^Qhh, Re, Hhd^Qhh, Re, Hhd^Qhh, Re^Vo, Hhd^Qhh, Re, Co, Re, Gll^Fdf, Gll^Fdf, Hhd^Qhh, Gd, Hhd^Qhh, Gd, Gd, Gd, Rb^Edt, Re^Edt, Gd, Rb^Edt, Gd, Gd^Fdf, Gll^Fdf, Gll^Fdf, Gll^Fdf, Gd^Fdf, Gll^Fdf, Gll^Fdf, Gll^Fdf, Gll^Fmf, Gll^Fdf, Gll, Gll, Gll, Gll^Fdf, Gd^Fdf, Gd^Fdf, Gll^Fdf, Gll^Fdf, Gll^Fdf, Gll^Fmf, Gd^Fdf, Gll^Fdw, Gll^Fmf
Md^Qhh, Md^Qhh, Md^Qhh, Hhd^Qhh, Md^Qhh, Hhd^Qhh, Md^Qhh, Hhd^Qhh, Hhd^Qhh, Hhd^Qhh, Hhd^Qhh, Hhd^Qhh, Hhd^Fdf, Hhd^Fdf, Gll^Fdf, Gll^Fmf, Gll^Fdf, Hhd^Fdf, Hhd^Qhh, Gd, Gd, Gd, Re, Rb^Edt, Re^Edt, Gd, Ss^Fp, Gll^Fmf, Gd^Fdf, Gd^Fdf, Gll^Em, Gd^Fdf, Gll^Em, Gll^Em, Gll^Fdf, Gd^Fdf, Gll^Fdw, Gll^Fdf, Gll^Fdw, Gll^Fdf, Gd^Fdf, Gd^Fdf, Rb^Fdf, Gll^Fdf, Gll^Fdw, Gd^Fdf, Gd^Fdf, Gd^Fdf, Gll^Fmf, Gll^Fdf
Hhd^Qhh, Hhd^Qhh, Md^Qhh, Md^Qhh, Hhd^Qhh, Md^Qhh, Hhd^Qhh, Hhd^Qhh, Hhd^Fdf, Hhd^Fmf, Hhd^Fdf, Hhd^Fmf, Hhd^Fdf, Gll^Fmf, Gll^Fmf, Gll^Fmf, Gll^Fdf, Gll^Fdf, Gll^Fdf, Gd, Gd^Fp, Gd, Gd, Rb^Edt, Rb, Gd^Ewl, Gd, Gd^Fdf, Gll^Fdf, Gd^Fdf, Gll^Fmf, Gll^Fdf, Gd^Fdf, Gll^Fdf, Gll^Fdf, Gll^Fmf, Gll^Fdf, Gll^Fdf, Gd^Fdf, Gd^Fdf, Gll^Fdf, Gll^Fdf, Gd^Fdf, Gll^Fdf, Gll^Fdw, Gd^Fdf, Gd^Fdf, Gll^Fdf, Gd^Fdf, Gd^Fdf
Hhd^Qhh, Hhd^Qhh, Hhd^Qhh, Hhd^Qhh, Hhd^Qhh, Md^Qhh, Hhd^Qhh, Hhd^Qhh, Hhd^Qhh, Hhd^Fdf, Hhd^Fdf, Hhd, Hhd, Hhd^Fdf, Gd, Gll^Fmf, Gll^Fmf, Gll^Fmf, Gll^Fdf, Gll^Fdf, Gll, Gd, Gll, Rb, Re, Gd^Edt, Gd^Edt, Gd^Edt, Gll^Fmf, Gll^Fmf, Gll^Fmw, Gd^Fdf, Gd^Fdf, Gd^Fdf, Gd^Fdf, Gd^Fdf, Aa^Fp, Gd^Fdf, Gll^Fmw, Gd^Fdf, Gd^Fdf, Gll^Fdf, Gll^Fdf, Gll^Fdw, Gll^Fdw, Gll^Fdf, Gll^Fdf, Gll^Fmf, Gd^Fdf, Gd^Fdf
