Ms, Ms, Ms, Ms, Ms^Xm, Ms, Ms, Ms, Ms, Ms, Ms, Hhd, Ms, Ms, Ha, Ha, Ms, Hhd, Ms, Ms, Ms, Ms, Ms, Ms, Ms, Hhd, Ha, Ha, Aa^Fpa, Ms, Ms, Ms, Ms, Gd, Ms, Gd, Ms, Gd, Ha, Ai, Wwrg, Aa, Aa^Fpa, Aa^Fpa, Ms, Ms, Ms, Gd, Ms, Ms
Ms, Ms, Ms, Ms^Xm, Ms, Ms, Ms, Ms, Ms, Ms, Ha, Ms, Ha, Ha, Ha, Ha, Ms, Ms, Ms, Mm, Ms, Ms, Ms^Xm, Ms, Ms, Ha, Ha, Aa^Fpa, Aa^Fpa, Aa^Fpa, Aa^Fpa, Ha, Ha, Ms, Ms, Ms, Ms, Ms, Ha, Ai, Wog, Aa, Ha, Aa^Fpa, Ha, Ms, Ms, Ms, Aa^Fpa, Aa^Fpa
Ms, Ms, Ms, Ms, Ms, Ms, Ha, Ha, Ha, Ms, Ha, Ha, Ha, Ha, Ms, Ha, Ms, Ms, Ms, Ms, Ms, Ms^Xm, Ms^Xm, Ms, Ms, Ms, Ms, Ms, Ms, Ms, Ms, Ha, Ms, Wwrg, Wog, Ha, Ha, Ha, Aa, Wog, Ai, Ha, Ha, Ms, Ms, Ha, Ha, Aa^Fpa, Aa^Fpa, Aa^Fpa
Ms, Ms, Ms, Ha, Ms, Ms, Ms, Ha, Ha, Ha, Ms, Ha, Ms, Ms, Ms, Ms, Mm, Mm, Mm, Mm, Mm, Mm, Mm, Ms^Xm, Ms^Xm, Mm, Mm^Xm, Ms, Mm, Ms, Ms, Ms, Ms, Ms, Wog, Ha, Ha, Ha, Wwg, Wog, Aa, Ha, Ms, Ms, Ms, Ms, Ha, Ha, Ms, Ha
Ha, Ha, Ha, Ha, Ms, Ms, Ha, Ha, Ha, Ha, Ha, Ha, Ms, Ms, Ms^Xm, Ms^Xm, Mm, Mv, Cte, Mm, Cte, Mv, Mm, Mm, Ms, Ms, Mm, Mm, Wog, Mm, Ha, Ha, Ha, Ha, Ha, Wog, Wog, Wog, Ai, Wog, Wog, Ms, Wog, Wwrg, Ms, Ha, Ms^Xm, Ms^Xm, Ms^Xm, Ms
Ms, Ha, Ha, Ms, Ha, Ms, Ha, Ha, Ms, Ha, Ms, Ms, Mm, Ms, Mm, Mm, Cte, Cte, Cf, Cte, Cf, Cte, Cte, Mm, Mm, Ms, Mm, Wwrg, Ha, Wog, Ha, Ha, Ha, Aa, Wog, Ai, Aa, Ha, Ha, Aa, Ha, Wog, Ha, Ms, Ms^Xm, Ms^Xm, Ms^Xm, Ms^Xm, Ms, Ms^Xm
Ms, Ms, Ha, Ha, Ha, Ha, Ha, Ha, Ms, Ms, Mm, Mm, Mm, Mm, Mm, Mv, Cte, Ql, Cf, 4 Cf^Kov, Cf, Ql, Cte, Mv, Mm, Ms, Mm, Mm, Ha, Wog, Wog, Wwg, Wog, Wog, Wog, Ai, Aa, Aa, Ms, Ha, Ms, Ha, Ms, Ms, Ms, Ms, Ms^Xm, Ms, Ha, Ms
Ms, Ms, Ms, Ha, Ha, Ms, Ms, Ha, Mm, Ms, Ha, Ms, Ha, Mm, Mm, Mm, Hhd, Cte, Cte, Cte, Cte, Cte, Hhd, Mm, Ms, Mm, Mm, Mm, Mm, Ha, Ha, Wog, Ai, Wwg, Ha, Ha, Ms, Ms, Cte, Ms, Ms, Ms^Xm, Ms, Ms, Ha, Ms, Ms, Aa^Fpa, Aa^Fpa, Ha
Ha, Ha, Ha^Esa, Aa, Ha, Ms, Ha, Mm, Mm, Ms, Ha, Ha, Ha, Mm, Mm, Hhd, Mm, Mv, Mm, Hhd, Mm, Mv, Mm, Hhd, Mm, Ms^Xm, Ms^Xm, Hhd, Hhd, Ha, Wog, Wog, Aa^Esa, Ha, Ha, Ms, Cte, Cte, 5 Kte, Cte, Ms^Xm, Ms^Xm, Ms, Aa^Fpa, Aa^Fpa, Ms, Aa^Fpa, Aa^Fpa, Ms, Ms
Hhd, Ha, Aa, Aa, Ha, Ha, Ha, Mm, Mm, Ha, Ha, Ha, Hhd, Mm, Hhd, Hhd, Mm, Mm, Mm, Hhd, Mm, Mm, Mm, Hhd, Mm, Mm, Mm, Mm, Hhd, Hhd, Wog, Ai, Hhd, Ha, Mm, Mm, Mm, Cte, Chr, Chr, Ms, Ms, Ha, Aa^Fpa, Ms, Ha, Ms, Ha, Ms, Ms
Hhd, Ha, Aa, Aa, Hhd, Hhd, Hhd, Mm, Hhd, Hhd, Hhd, Aa, Aa, Hhd, Hhd, Hhd, Hhd, Mm, Hhd, Hhd, Hhd, Mm, Hhd, Hhd, Hhd, Mm, Mm, Hhd, Hhd, Wog, Wog, Wwg, Gll^Fp, Hhd, Hhd, Mm, Mm, Mm, Mm, Chr, Ms, Ha, Ha, Ms, Ha, Ms, Ms, Ms, Ha, Ha
Hhd, Ha, Hhd, Aa, Aa, Aa, Hhd, Hhd, Hhd, Gd^Es, Gd, Aa, Aa, Hhd, Hhd, Hhd, Hhd, Hhd, Gd, Hhd, Gd^Es, Hhd, Hhd, Hhd, Hhd, Mm, Hhd, Hhd, Ai, Wwrg, Gll^Fp, Gll^Fp, Hhd, Hhd, Hhd, Hhd, Mm, Mm, Mm, Hhd, Hhd, Ha, Hhd, Ha, Ha, Ha, Ha, Ha, Aa, Ha
Hhd, Hhd, Hhd, Hhd, Hhd, Aa, Aa, Hhd, Hhd, Gd, Gd, Aa, Gd, Aa, Gd, Gd^Es, Gd, Gd, Gd, Gd, Gll^Fp, Hhd, Gll^Fp, Hhd, Hhd, Hhd, Hhd, Gd, Hhd, Wwg, Ai, Gll^Fmw, Hhd^Fp, Hhd, Gd^Fp, Hhd, Hhd, Hhd, Hhd, Hhd, Hhd, Hhd, Hhd, Ha, Ha, Aa, Aa, Ha, Aa, Aa
Mm, Hhd, Hhd, Hhd, Hhd, Aa, Aa, Aa, Gd, Gd^Es, Gd, Gd, Gd, Gd, Gd, Gd, Re^Vo, Re, Re^Fp, Re^Fp, Re^Fmf, Re^Fp, Re^Fp, Hhd, Re^Fp, Hhd, Re, Gd, Re, Wwg, Wwg, Gll^Fmw, Gd^Fp, Gll^Fmf, Gll^Fmw, Hhd, Re^Fp, Re^Fp, Hhd^Fp, Hhd, Gll^Fp, Hhd, Hhd, Aa, Aa, Aa, Aa, Aa, Aa, Aa
Mm, Mm, Hhd, Hhd, Hhd, Aa, Aa, Aa, Gd, Gd, Gd, Aa, Aa, Gd, Hhd, Re^Edt, Re^Edt, Gd, Gd^Fp, Hhd, Hhd, Hhd, Hhd, Re^Fmf, Hhd, Re^Fmf, Re^Fp, Re, Wwg, Chr, Wwg^Bw\r, Gll, Gll, Gll^Fmw, Gll^Fp, Gll^Fp, Hhd, Gll^Fp, Gs^Vc, Gd^Fp, Hhd, Hhd, Hhd, Hhd, Hhd, Aa, Aa, Aa, Aa, Aa
Mm, Mm, Wwrg, Hhd, Hhd, Hhd, Gd^Es, Gd, Re, Gd, Rb, Aa, Gd^Es, Aa, Hhd, Rb, Re, Gd, Hhd, Gd^Fp, Mm, Mm, Wwrg, Hhd, Hhd, Re^Fp, Gd^Fp, Ai, Gd, Wwg, Gd, Chr, Rb^Edb, Gll^Fp, Re^Vhr, Hhd, Hhd, Hhd^Fp, Gd^Fp, Gd^Fp, Gll^Fp, Gll^Fp, Hhd, Hhd, Hhd, Aa, Gd^Es, Aa, Gd, Aa
Gd, Wwf, Gd, Hhd, Hhd, Gd, Gd, Gd, Re, Re^Vo, Re^Edt, Gd, Hhd, Hhd, Hhd, Hhd, Re, Re, Hhd, Hhd, Hhd, Hhd, Gd^Fp, Wwg, Gd^Fp, Gd^Fp, Wwrg, Ai, Gd, Gd, Hhd, Rb, Rb^Edb, Rb^Edb, Rb, Rb, Rb^Edb, Hhd, Hhd, Hhd^Fp, Gll^Fp, Gll^Fp, Gll^Fmw, Hhd, Gd^Es, Hhd, Gd, Gd, Gll, Gd
Gd, Wwf, Wog, Gd, Gd, Gd, Re, Re, Gd, Re^Edt, Rb, Gd, Hhd, Gd^Es, Rb, Re, Re^Vo, Gd, Gd, Hhd, Gd, Gd^Fp, Wog, Wog, Wog, Wog, Gd, Gd, Gd^Es, Hhd, Hhd, Re, Rb^Vhr, Rb, Re^Dr, Rb^Edb, Rb^Edb, Re^Vhr, Hhd, Hhd, Hhd^Fp, Gll^Fp, Gll^Fp, Hhd, Gd, Gd, Gll, 6 Gll, Gll^Fmf, Gll
Wog, Wog, Wog, Wwg, Wog, Wog, Wog^Bp|, Wog^Bp|, Wog, Gd, Gd, Gd, Gd^Es, Gd, Gd, Rb^Edt, Re^Edt, Gd, Gd, Hhd, Gd, Wwg, Gd, Gd, Gd, Gd^Es, Hhd, Hhd, Hhd, Hhd, Hhd, Re^Edb, Hhd, Rb^Edb, Gll^Fp, Chr, Re^Fp, Rb, Hhd, Gd^Es, Gll, Gll^Fp, Gll, Gll^Fp, Gll, Gll, Gll, Gd^Fp, Re^Fp, Gll^Fmw
Wwg, Wog, Ai, Wog, Ai, Wwg, Re, Re, Wog, Wwg, Gd, Gd, Gd, Gd, Gd, Re^Edt, Gd, Re, Re, Gd, Wwg, Ai, Gll, Hhd^Fp, Hhd, Hhd, Mm, Mm, Mm, Mm, Mm, Mm, Hhd, Gd^Fp, Gll^Fp, Gll^Fp, Gll^Fp, Rb, Re, Gd, Gd, Gll, Gd, Gd, Gll, Gll^Fp, Gd^Fp, Gll^Fp, Gd^Fp, Re^Fp
Ai, Ai, Gd, Ai, Rb^Vct, Rb^Edt, Rb^Edt, Gd, Gd, Wwg, Wwg, Gd, Gd, Gd, Gd^Es, Gd, Gd, Gd, Wog, Wog^Bp\, Re, Gd, Gd^Fp, Gd^Fp, Hhd^Fp, Hhd, Hhd^Fp, Hhd, Mm, Mm, Hhd, Wwrg, Wwg, Gll, Gll, Gll^Fp, Gll, Gll, Re, Gd, Gd, Gd, Gd^Es, Gd, Gd, Gll, Gd^Fp, Gd^Fp, Gd^Fp, Gll^Fmw
Gd, Gd, Gd, Rb^Vct, Co, Co, Co, Rb^Edt, Gd, Ai, Wog, Ai, Gd, Gd, Gd, Gd^Es, Gd, Gd, Wwg, Gd, Rb, Gd, Rb^Edt, Gll^Es, Gd^Fp, Gll^Fp, Gd^Fp, Hhd, Hhd, Hhd, Hhd^Fp, Hhd, Wwg, Gll^Fp, Gll, Gll, Cer^Vo, Gd, Gd, Gd, Gd, Gd^Es, Gd^Es, Gd, Gd, Gll^Fmw, Gd^Fp, Gd^Fp, Gd^Fp, Gd^Fp
Gd, Gd, Gd, Rb^Vct, Co, Co, Ko, Rb^Edt, Rb^Edt, Gd, Re, Wog^Bp/, Wog, Gd, Gd, Gd, Gd, Wwg, Gd, Gd^Edt, Rb^Vo, Rb^Edt, Rb^Edt, Rb^Vo, Gll, Re^Fp, Hhd, Hhd^Fp, Hhd, Hhd, Gll^Fp, Hhd^Fp, Gd^Fp, Wwg, Gd, Gd, Re, Re^Edb, Gd, Gd, Gd, Gd, Gd, Gd, Gd, Gll, Gd, Hhd, Hhd, Gd^Fmf
Gd, Gd, Gd, Rb^Edt, Rb^Edt, Ko, Ko, Co, Co, Rb^Edt, Gd, Wog, Wog, Wog^Bp|, Wog, Wwg, Wog, Wwg, Wwg, Gd, Gd, Rb, Re, Rb^Edt, Gd, Gll, Gd, Gd^Es, Gd, Gll^Fp, Cer^Vo, Gll^Fp, Gd^Fp, Wwg, Gd, Gd, Gd, Gd, Re^Edb, Gd^Edb, Gd, Gd, Gd, Gd^Es, Gd, Gd, Hhd, Hhd, Mm, Hhd
Hhd, Gd, Gd, Gd, Gd, Rb^Edt, Co, Co, Co, Rb^Vct, Re^Edt, Gd, Re, Re, Gd, Wog, Gd, Wog, Wwg, Wwg, Wwg, Gd, Wwg^Bp|, Gd, Gd, Gd, Gd, Gd, Gd, Gd^Edt, Gd^Edt, Gd^Fp, Wwf, Wwg, Gd, Gd, Gd, Gd, Re, Re^Vo, Gd, Gd, Gd^Es, Gd, Gd, Gd^Es, Hhd, Hhd, Mm, Mm
Hhd, Gd^Es, Hhd, Gd^Es, Gd, Rb^Edt, Rb^Edt, Co, Rb^Vct, Rb^Vct, Rb^Edt, Re, Gd, Gd, Gd, Gd, Re^Vo, Gd, Gd, Gd, Gd, Wwg^Bp|, Rb, Wwg^Bp|, Wwg, Wwg, Ai, Ai, Ai, Wwg, Wwg, Wwf, Gd, Gd, Gd, Re^Edb, Re^Edb, Gd, Gd, Gd, Gd, Hhd, Hhd, Hhd, Hhd, Gd, Gd, Gd, Mm, Hhd
Hhd, Hhd, Md, Hhd, Hhd, Gd, Gd, Rb^Edt, Gd, Re^Edt, Rb^Edt, Re^Edt, Re^Edt, Gd, Gd, Gd^Es, Gd, Gd, Rb^Edb, Rb, Rb^Edb, Rb, Rb^Edt, Rb, Gd, Gd, Gd, Gd, Gd, Gd, Gd, Gd, Gd, Gd, Gd^Edb, Re^Vo, Gd, Gd, Rb^Edt, Rb^Edt, Rb^Edt, Hhd, Co, Hhd, Hhd, Gd, Gd, Hhd, Hhd, Hhd
Hhd, Md, Hhd, Md, Hhd, Gd^Es, Hhd, Gd, Gd, Gd, Re^Edt, Rb^Edt, Rb^Edt, Rb^Edt, Rb^Edt, Re^Edt, Rb^Edt, Rb^Edt, Rb^Edt, Co, Rb^Edt, Rb^Edb, Co, Rb^Edt, Rb^Edt, Gd, Rb^Edt, Gd, Gd, Gd, Gd, Gd, Gd, Gd, Gd, Gd, Re^Edt, Rb^Edt, Co, Co, Ko, Ko, Co, Co, Rb^Vct, Hhd, Gd, Gd^Es, Hhd, Hhd
Hhd, Hhd, Hhd, Md, Md, Hhd, Hhd, Gd^Es, Hhd, Gd, Gd, Re^Edt, Gd, Re^Edt, Rb^Edt, Rb^Edt, Rb^Edt, Co, Rb^Vct, Rb^Vct, Rb^Vct, Co, Rb^Edt, Co, Co, Rb^Edt, Co, Rb^Edt, Gd, Gd, Gd, Gd, Gd, Re, Gd, Gd, Rb^Edt, Rb^Edt, Co, Co, Co, Ko, Co, Co, Rb^Vct, Hhd, Gd, Gd, Gd^Es, Gd
Hhd, Hhd, Hhd, Md, Md, Hhd, Hhd, Hhd, Gd^Es, Gd, Gd, Gd, Gd, Gd, Gd, Rb^Edt, Rb^Edt, Rb^Edt, Co, Co, Co, Rb^Edt, Ko, Rb^Edt, Rb^Edt, Rb^Edt, Rb^Vct, Rb^Edt, Rb^Edt, Gd, Gd^Vo, Re^Edb, Gd, Gd, Re^Edt, Rb^Edt, Re^Edt, Rb^Edt, Rb^Vct, Co, Rb^Vct, Rb^Edt, Rb^Edt, Rb^Vct, Rb, Gd, Re^Edt, Gd, Gd, Gd
Gd, Hhd, Gd^Es, Hhd, Hhd, Md, Hhd, Hhd, Hhd, Hhd, Gd^Es, Gd, Gd, Gd, Gd, Rb^Edt, Co, Rb^Vct, Co, Co, Co, Ko, 3 Ko, Ko, Co, Co, Co, Rb^Vct, Co, Rb^Edt, Re, Gd, Re, Gd, Rb^Edt, Rb^Edt, Gd, Gd, Gd, Rb^Vct, Gll, Rb^Edt, Rb^Edt, Re^Edt, Rb^Edt, Rb^Edt, Rb^Edt, Re, Gd, Gd
Gd, Gd, Gd, Gd, Hhd, Hhd, Hhd, Md, Md, Hhd, Hhd, Hhd, Gd^Es, Gd, Re, Rb^Edt, Rb^Edt, Rb^Vct, Rb^Vct, Co, Rb^Edt, Ko, Ko, Ko, Co, Co, Co, Rb^Vct, Rb^Edt, Rb^Edt, Rb^Edt, Rb^Edt, Rb^Edt, Rb^Edt, Re^Edt, Re^Edt, Gll^Fdf, Gll, Gll^_s, Gll, Gll, Gd^Fdf, Gll^Fdf, Rb^Edt, Gll^Fdf, Gd^Fdf, Gll^Fdf, Rb^Edt, Re^Edt, Gd
Rb^Edt, Re, Rb^Edt, Re, Re^Edt, Re^Vo, Re^Edt, Hhd, Hhd, Hhd, Hhd, Hhd, Hhd, Re, Rb^Edt, Rb^Edt, Rb^Edt, Co, Rb^Edt, Rb^Edt, Co, Rb^Edt, Rb^Edt, Rb^Edt, Rb^Vct, Co, Rb^Vct, Rb^Edt, Rb^Edt, Re, Gd, Gd, Gd, Gll, Gll, Gll^Fmf, Gd^_s, Gd^_s, Rb^Fdf, Gll^_s, Gll^_s, Gd^Fdf, Gd^Fdf, Rb^Fdf, Gll^Fdf, Gd^Fdf, Gll^Fdw, Rb^Edt, Rb^Edt, Rb^Edt
Re, Rb^Edt, Re, Rb^Edt, Rb^Edt, Rb^Edt, Rb^Edt, Re, Rb^Edt, Re, Rb^Edt, Re, Co, Re, Rb^Edt, Re, Gd, Rb^Edt, Gd, Rb^Edt, Rb, Co, Co, Co, Rb^Edt, Rb^Vct, Rb^Edt, Co, Rb^Edt, Gd, Gd^Fdf, Gd, Gll, Gll^Fdf, Gll^Fdf, Gll^_s, Gd^Fdf, Gd^Fdf, Gll^Feth, Gll, Gll^Fdf, Gd^_s, Gll^Fdf, Gll^Fdf, Gll^Fmf, Gd^Fdf, Gd^Fdf, Gd^Fdf, Gll^Fdf, Gll^Fdf
Re, Re, Hhd, Re, Hhd, Re, Re, Rb^Edt, Re^Edt, Rb^Edt, Re^Edt, Rb^Edt, Rb^Edt, Rb^Edt, Re, Hhd, Hhd, Gd, Gd, Gd^Em, Gd, Rb^Edt, Rb^Edt, Rb^Edt, Rb^Edt, Co, Rb^Edt, Rb^Edt, Gd^Fdf, Gll, Gll^Fdw, Gll^Fdf, Gd^Fdf, Gll^Fdf, Gll^Fmf, Gll^_s, Gll^Fdf, 2 Gll^Em, Gd, 1 Gll, Gll^Fdf, Gll^_s, Gll^Fdw, Gd^Fdf, Gll^Fdf, Gll^Fdf, Gll^Fmf, Gll^Fdw, Gll^Fdw, Gd^Fdf
Hhd, Hhd, Md, Hhd, Hhd, Re, Hhd, Re, Hhd, Re^Vo, Hhd, Re, Co, Re, Gll^Fdf, Gll^Fdf, Hhd, Gd, Hhd, Gd, Gd, Gd, Rb^Edt, Re^Edt, Gd, Rb^Edt, Gd, Gd^Fdf, Gll^Fdf, Gll^Fdf, Gll^Fdf, Gd^Fdf, Gll^Fdf, Gll^Fdf, Gll^Fdf, Gll^_s, Gll^Fdf, Gll, Gll, Gll, Gll^Fdf, Gd^_s, Gd^Fdf, Gll^Fdf, Gll^Fdf, Gll^Fdf, Gll^Fmf, Gd^Fdf, Gll^Fdw, Gll^Fmf
Md, Md, Md, Hhd, Md, Hhd, Md, Hhd, Hhd, Hhd, Hhd, Hhd, Hhd^Fdf, Hhd^Fdf, Gll^Fdf, Gll^Fmf, Gll^Fdf, Hhd^Fdf, Hhd, Gd, Gd, Gd, Re, Rb^Edt, Re^Edt, Gd, Ss^Fp, Gll^Fmf, Gd^Fdf, Gd^Fdf, Gll^Em, Gd^Fdf, Gll^Em, Gll^Em, Gll^Fdf, Gd^_s, Gll^_s, Gll^Fdf, Gll^Fdw, Gll^Fdf, Gd^_s, Gd^_s, Rb^Fdf, Gll^Fdf, Gll^Fdw, Gd^Fdf, Gd^Fdf, Gd^Fdf, Gll^Fmf, Gll^Fdf
Hhd, Hhd, Md, Md, Hhd, Md, Hhd, Hhd, Hhd^Fdf, Hhd^Fmf, Hhd^Fdf, Hhd^Fmf, Hhd^Fdf, Gll^Fmf, Gll^Fmf, Gll^Fmf, Gll^Fdf, Gll^Fdf, Gll^Fdf, Gd, Gd^Fp, Gd, Gd, Rb^Edt, Rb, Gd^Ewl, Gd, Gd^Fdf, Gll^Fdf, Gd^Fdf, Gll^Fmf, Gll^Fdf, Gd^Fdf, Gll^Fdf, Gll^Fdf, Gll^Fmf, Gll^Fdf, Gll^_s, Gd^_s, Gd^_s, Gll^Fdf, Gll^Fdf, Gd^Fdf, Gll^Fdf, Gll^Fdw, Gd^Fdf, Gd^Fdf, Gll^Fdf, Gd^Fdf, Gd^Fdf
Hhd, Hhd, Hhd, Hhd, Hhd, Md, Hhd, Hhd, Hhd, Hhd^Fdf, Hhd^Fdf, Hhd, Hhd, Hhd^Fdf, Gd, Gll^Fmf, Gll^Fmf, Gll^Fmf, Gll^Fdf, Gll^Fdf, Gll, Gd, Gll, Rb, Re, Gd^Edt, Gd^Edt, Gd^Edt, Gll^Fmf, Gll^Fmf, Gll^Fmw, Gd^Fdf, Gd^Fdf, Gd^Fdf, Gd^Fdf, Gd^Fdf, Aa^Fp, Gd^Fdf, Gll^Fmw, Gd^Fdf, Gd^Fdf, Gll^Fdf, Gll^Fdf, Gll^Fdw, Gll^Fdw, Gll^Fdf, Gll^Fdf, Gll^Fmf, Gd^Fdf, Gd^Fdf
