Mm, Mm, Mm, Mm, Mm^Xm, Mm, Mm, Mm, Mm, Mm, Mm, Hhd, Mm, Mm, Ha, Ha, Ha, Hhd, Hhd, Hhd, Mm, Mm, Mm, Mm, Mm, Hhd, Ha, Ha, Ha, Hh, Mm, Mm, Mm, Gd, Mm, Gd, Mm, Gd, Gll^Esa, Wwg, Wwf, Hhd, Ha, Gd, Mm, Mm, Mm, Gd, Mm, Mm
Mm, Mm, Mm, Mm^Xm, Mm, Mm, Mm, Mm, Mm, Mm, Hhd, Mm, Ha, Ha, Ha, Ha, Ha, Mm, Mm, Mm, Mm, Mm, Mm^Xm, Mm, Mm, Ha, Ha, Ha, Ha, Ha, Ha, Ha, Ha, Mm, Mm, Mm, Mm, Mm, Ha, Ai^Esa, Ha, Ha, Ha, Ha, Ha, Mm, Mm, Mm, Ha, Ha
Mm, Mm, Mm, Mm, Mm, Mm, Hhd, Hhd, Ha, Mm, Ha, Ha, Hhd, Ha, Mm, Ha, Mm, Mm, Mm, Mm, Mm, Mm^Xm, Mm^Xm, Mm, Mm, Mm, Mm, Mm, Mm, Mm, Mm, Hhd, Mm, Hhd, Hhd, Ha, Ha, Ha, Aa^Esa, Wwf, Wwg, Ha, Ha, Mm, Mm, Ha, Ha, Ha, Ha, Ha
Mm, Mm, Mm, Hhd, Mm, Mm, Mm, Hhd, Ha, Ha, Ha, Ha, Mm, Hhd, Mm, Mm, Mm^Xm, Mm, Mm, Mm, Mm, Mm, Mm, Mm^Xm, Mm^Xm, Mm, Mm^Xm, Mm, Mm, Mm, Mm, Mm, Mm, Mm, Hhd, Hhd, Ha, Ha, Ha, Wwf, Ha, Ha, Mm, Mm, Mm, Mm, Ha, Ha, Mm, Ha
Ha, Ha, Hhd, Hhd, Mm, Mm, Hhd, Ha, Ha, Ha, Hhd, Ha, Mm, Mm, Mm^Xm, Mm^Xm, Mm, Mv, Cte, Mm, Cte, Mv, Mm, Mm^Xm, Mm^Xm, Mm^Xm, Mm, Mm, Ha, Mm, Ha, Ha, Ha, Ha, Ha, Wwg, Ai, Ai^Esa, Wwf, Wwf, Ha, Mm, Ha, Ha, Mm, Ha, Mm^Xm, Mm^Xm, Mm^Xm, Mm
Ha, Ha, Ha, Mm, Hhd, Mm, Ha, Ha, Mm, Hhd, Mm, Mm, Mm, Mm, Mm^Xm, Mm, Cte, Cte, Cf, Cte, Cf, Cte, Cte, Mm, Mm, Mm, Mm, Ha, Hhd, Ha, Hhd, Ha, Ha, Aa^Esa, Wwf, Wwf, Gll^Esa, Hhd, Hhd, Aa^Esa, Ha, Ha, Ha, Mm, Mm^Xm, Mm^Xm, Mm^Xm, Mm^Xm, Mm, Mm^Xm
Ha, Ha, Ha, Ha, Hhd, Hhd, Ha, Ha, Mm, Mm, Mm, Mm, Mm, Mm^Xm, Mm, Mv, Cte, Cte, Cf, 4 Cf^Kov, Cf, Cte, Cte, Mv, Mm, Mm, Mm, Mm, Hhd, Ha, Hhd, Gll^Esa, Wwf, Wwf, Wwrg, Ha, Hhd, Hhd, Mm, Hhd, Mm, Ha, Mm, Mm, Mm, Mm, Mm^Xm, Mm, Ha, Mm
Hhd, Ha, Ha, Ha, Hhd, Ha, Hhd, Hhd, Mm, Mm, Mm, Mm, Hhd, Mm, Mm, Mm, Mm, Cte, Cte, Cte, Cte, Cte, Mm, Mm, Mm, Mm, Mm, Mm, Mm, Hhd, Hhd, Wwf, Wwg, Ha, Ha, Ha, Mm, Mm, Cte, Mm, Mm, Mm^Xm, Mm, Mm, Ha, Mm, Mm, Ha, Ha, Ha
Hhd, Hhd, Ha^Esa, Aa, Hhd, Hhd, Hhd, Mm, Mm, Mm, Hhd, Mm, Hhd, Mm, Mm, Mm, Mm, Mv, Mm, Hhd, Mm, Mv, Mm, Mm, Mm, Mm^Xm, Mm^Xm, Hhd, Hhd, Hhd, Ai, Wwf, Aa^Esa, Ha, Hhd, Mm, Cte, Cte, 5 Kte, Cte, Mm^Xm, Mm^Xm, Mm, Ha, Ha, Mm, Ha, Ha, Mm, Mm
Hhd, Hhd, Aa^Esa, Aa, Hhd, Gll^Fmw, Hhd, Mm, Mm, Hhd, Hhd, Hhd, Hhd, Mm, Hhd, Mm, Mm, Mm, Mm, Hhd, Mm, Mm, Mm, Mm, Mm, Mm, Mm, Mm, Hhd, Hhd, Ai, Ai, Ha, Ha, Mm, Mm, Mm, Cte, Chr, Chr, Mm, Mm, Ha, Ha, Mm, Ha, Mm, Ha, Mm, Mm
Hhd, Hhd^Fmw, Aa^Esa, Aa^Esa, Gd^Fmw, Hhd^Fdw, Gll^Fmw, Mm, Hhd, Hhd, Hhd, Gll, Gll^Esa, Hhd^Fdw, Gll^Fmw, Hhd^Fmw, Hhd, Mm, Hhd, Hhd, Hhd, Mm, Hhd, Hhd, Hhd, Mm, Mm, Hhd, Hhd, Wwf, Aa^Esa, Gll, Hhd, Hhd, Hhd, Mm, Mm, Mm, Mm, Chr, Mm, Hhd, Hhd, Mm, Ha, Mm, Mm, Mm, Ha, Ha
Hhd, Hhd^Fmw, Hhd, Aa, Aa, Aa, Gd^Fdw, Hhd, Hhd, Gll^Esa, Aa, Aa, Gll^Esa, Hhd, Gd^Fdw, Gll^Fmw, Gd^Fmw, Hhd, Gll, Rb, Gll^Es, Hhd, Gll^Fmw, Hhd, Hhd, Chr, Mm, Hhd, Aa, Wwf, Aa^Esa, Hhd, Hhd, Hhd, Gd, Hhd, Mm, Mm, Hhd, Mm, Hhd, Hhd, Hhd, Hhd, Ha, Ha, Ha, Ha, Aa, Ha
Hhd, Hhd, Hhd, Gll^Fmw, Gll^Fmw, Aa, Aa^Esa, Hhd, Hhd, Gd, Aa, Aa^Esa, Gll, Gd, Gd, Gd^Es, Gd, Gll, Rb, Rb^Es, Gll^Es, Gd^Fmf, Hhd^Fmw, Hhd, Mm, Chr, Chr, Gll^Es, Hhd, Ai, Wwf, Gll, Gd, Gd, Gd, Hhd, Hhd, Hhd, Hhd, Hhd, Hhd, Hhd, Hhd, Ha, Ha, Aa, Aa, Ha, Aa^Esa, Aa
Mm, Hhd, Hhd, Gll^Fdw, Hhd, Aa^Esa, Aa^Esa, Aa, Gd, Gd, Gll, Gll, Gll, Gd^Es, Gd, Gd, Gd^Vo, Rb, Gd, Gll, Hhd, Gll^Fmw, Hhd, Hhd^Fmw, Hhd, Hhd, Gll^Edb, Gll^Edb, Gll^Edb, Ai, Wwf, Gll, Hhd, Hhd, Hhd, Hhd, Hhd, Hhd, Mm, Mm, Hhd, Hhd, Aa, Aa, Aa, Aa^Esa, Aa^Esa, Aa^Esa, Aa^Esa, Aa^Esa
Mm, Mm, Hhd, Hhd, Hhd^Fmf, Aa, Aa, Aa^Esa, Gd^Esa, Gd, Gd, Gd, Gd, Gd, Gd, Gd^Edb, Rb^Edb, Rb, Gd^Es, Hhd, Hhd, Hhd, Mm, Hhd, Hhd, Hhd, Hhd, Hhd, Wwf, Gll, Wwf, Gll, Gll, Gll^Fmw, Gd, Hhd, Gd, Gd, Mm, Mm, Hhd, Hhd, Hhd, Hhd, Hhd, Aa, Aa^Esa, Aa, Aa, Aa
Mm, Mm, Wwrg, Hhd, Gll^Fmw, Hhd, Gd, Gd^Esa, Gd^Es, Gd^Es, Gd, Hhd, Gll^Fdw, Gd, Hhd, Gd^Edb, Rb, Gd^Es, Gd, Gd, Gll^Fmw, Mm, Gll, Hhd, Hhd, Gll, Hhd, Wwf, Ai^Esa, Wwf, Chr, Chr^Dr, Rb^Es, Gll, Rb^Vhhr, Hhd, Gd, Gd^Fmw, Hhd, Hhd, Gd^Fmw, Gd^Fmw, Gd^Fmw, Hhd, Gd^Esa, Aa, Gd^Esa, Aa^Esa, Gd, Gd^Esa
Gd, Wwf, Gll, Hhd, Hhd, Gd, Gd, Gd, Gd^Edb, Gd^Vo, Hhd, Hhd, Mm, Hhd, Gll^Es, Gd^Es, Rb, Gd, Gd, Hhd, Hhd, Mm, Gll, Hhd, Ai^Esa, Gll, Wwf, Wwf, Gll, Aa, Hhd, Rb^Es, Gll^Edb, Rb^Edb, Rb^Edb, Gll^Es, Gd^Es, Hhd, Hhd, Hhd, Chr^Edb, Rb, Hhd, Hhd, Gd^Fmw, Gd, Gd, Gd, Rb^Dr, Gd
Gd, Wwf, Wwf, Gll, Gll, Gll, Gll, Gll, Gll, Gll^Edb, Gll^Es, Wwrg, Mm, Mm, Hhd, Gd^Es, Gd^Vo, Rb, Gd, Gd, Gll^Es, Gll, Wwf, Wwf, Wwf, Wwf, Gll, Wwf, Wwf, Hhd, Hhd, Gd^Es, Rb^Vhhr, Rb^Edb, Rb^Edb, Hhd, Hhd, Hhd^Vhhr, Hhd, Chr^Edb, Rb^Es, Chr^Edb, Rb^Edb, Gd^Fmw, Gll, Gd, Rb, 6 Gd, Gd, Gd
Wwrg, Wwrg, Wwf, Wwf, Wwf, Wwf, Wwf, Wwf^Bp|, Wwrg, Gll, Wwf, Wwf, Hhd^Fmw, Mm, Hhd, Gd, Gd^Es, Rb^Edb, Rb, Gll, Gll, Wwf, Gll, Gll, Hhd, Gd, Gll^Fdw, Hhd, Hhd, Wwf, Hhd, Gd^Es, Hhd, Gll, Gd^Edb, Gd^Dr, Hhd, Hhd, Rb, Rb^Edb, Gll^Dr, Rb^Edb, Gd, Gll, Rb, Rb, Gd, Rb, Rb, Rb
Wwf, Wwrg, Gll, Wwg, Gll, Gll, Gll, Rb, Wwg, Wwf, Gll, Gd, Hhd, Hhd, Hhd, Hhd, Gd^Es, Gll^Es, Rb, Gll, Wwg, Wwf, Gll^Es, Hhd, Gd^Fdw, Hhd, Hhd, Gll^Fmf, Hhd, Wwf, Mm, Hhd, Mm, Gd, Chr, Rb^Edb, Rb, Hhd, Rb, Gll^Es, Gd^Es, Rb, Gd, Rb, Gll, Gd^Fmf, Hhd, Gd^Fmf, Gd^Fdf, Gd^Fmf
Gll, Gll, Gd, Gll, Rb^Vct, Rb^Edt, Rb^Edt, Rb, Gll, Wwf, Wwf, Gd, Hhd^Fmw, Gd, Gd^Es, Hhd^Fmw, Gll, Gll, Wwf, Wwf^Bp\, Rb, Gll, Gd, Gll, Hhd, Hhd, Hhd, Hhd, Hhd, Mm, Hhd, Mm, Wwrg, Hhd, Gll, Rb, Gll, Rb, Gd, Gd^Fmw, Gd^Fmf, Rb, Rb, Rb, Gd, Gd^Fmf, Mm, Hhd, Mm, Hhd
Gd, Gd, Gd^Es, Rb^Vct, Co, Co, Co, Rb^Edt, Gd, Gll, Wwf, Gll, Gll, Gd^Es, Gll^Es, Hhd, Gll, Gll, Wwg, Gll, Rb, Gd, Gd, Gll, Gd^Es, Gd, Gll, Gll^Fmw, Hhd, Hhd, Hhd, Hhd, Wwf, Gll, Gll, Gll, Rb^Vo, Rb, Gd, Gd^Fmw, Rb^Dr, Gd, Rb, Gd, Gd^Fp, Hhd, Hhd, Mm, Mm, Mm
Gd, Gd^Es, Gd^Es, Rb^Vct, Co, Co, Ko, Rb, Rb, Gll, Rb, Wwf^Bp/, Wwg, Gll, Gll, Gll, Gll, Wwg, Gll, Gd, Gd^Vo, Rb, Gd, Gd^Vo, Gd^Es, Gd, Hhd, Hhd, Hhd, Hhd, Gd, Hhd, Gll, Wwf, Gll, Gd^Edb, Gd^Edb, Gd^Edb, Gd, Gll^Es, Gll, Gll, Rb, Gd^Fmf, Hhd, Hhd, Hhd, Mm, Mm, Mm
Gd^Fmf, Gd, Gd, Rb, Rb, Ko, Ko, Co, Co, Rb^Edt, Gll, Wwf, Wwf, Wwg, Wwg, Wwg, Wwg, Wwg, Wwg, Gll, Gll, Rb^Edb, Rb, Gd^Edb, Gd^Edb, Gd, Gd, Gd, Gd, Gd^Es, Rb^Vo, Gd, Rb, Wwf, Rb, Gll, Rb, Gd, Rb, Gd, Rb, Gd, Rb, Gd, Gd^Fmf, Gd^Fp, Hhd, Hhd, Mm, Mm
Gd^Fmf, Gd^Fmf, Gd^Fmf, Gd, Gd, Rb, Co, Co, Co, Rb^Vct, Gd, Gll, Gll, Gll, Gll, Wwrg, Gll, Wwg, Wwg, Wwrg, Wwg, Gll, Wwf^Bp|, Gll, Gll, Gll, Gll, Gll, Gll, Rb^Edb, Rb, Rb, Wwf, Wwf, Gll, Rb, Gd, Rb, Gll^Edb, Rb^Vo, Gd, Rb, Gd^Fmf, Gd^Fp, Gd^Fdf, Gd^Fdf, Gd^Fmf, Hhd, Hhd, Mm
Hhd, Gd^Fmf, Hhd, Gd^Es, Gd, Rb, Rb, Co, Rb^Vct, Rb^Vct, Gd, Gd, Hhd, Hhd, Hhd, Gll, Gd^Vo, Gll, Gll, Gll, Gll, Wwf, Rb, Wwf, Wwf, Wwf, Wwf, Wwf, Wwf, Wwg, Wwg, Wwg, Gll, Gll, Gd, Rb, Gd, Gd^Fmw, Gll, Gll^Es, Gd, Rb, Rb^Edt, Gd^Fmf, Gd, Gd^Fmf, Gd^Fp, Gd^Fmf, Hhd, Hhd
Hhd, Hhd, Hhd, Hhd, Hhd, Gd, Gd, Rb, Gd, Rb, Rb, Gd, Gll, Gd, Gd, Gd^Es, Gd, Rb, Rb^Edb, Rb, Rb^Edb, Rb^Edb, Rb, Rb, Gd, Gd, Gd^Es, Gll, Gll^Fmw, Gll, Gd^Fmw, Gll^Fmw, Gd^Fmw, Gd, Gd^Edb, Rb^Vo, Rb, Gd, Rb^Edt, Rb^Edt, Rb, Rb^Edt, Co, Rb^Edt, Rb^Edt, Gd^Fmf, Gd^Fmf, Gd^Fp, Gd, Hhd
Hhd, Hhd, Hhd, Hhd, Hhd, Gd^Fmf, Gd^Fmf, Gd^Fmf, Gd, Gd, Gll, Rb^Edt, Rb^Edt, Gd, Gd, Gd, Rb, Rb, Rb, Co, Rb, Rb^Edb, Co, Rb, Rb, Gd^Es, Rb, Gll, Gll, Gd^Fmw, Gd, Gd^Fmw, Rb^Dr, Gd, Gd^Fmw, Gd^Fmw, Gll, Rb, Co, Co, Ko, Ko, Co, Co, Re^Vct, Rb^Edt, Rb, Gd^Feth, Gd^Fp, Gd^Fp
Mm, Hhd, Mm, Hhd, Mm, Hhd, Hhd, Gd^Fmf, Hhd, Gd, Gd^Es, Gll, Rb, Gll^Edt, Rb, Re, Rb^Edt, Co, Rb^Vct, Rb^Vct, Rb^Vct, Co, Rb, Co, Co, Rb, Co, Rb^Edt, Gd^Edt, Gll, Gll, Gd, Gd, Gd^Es, Gd, Gd, Gll^Edt, Rb, Co, Co, Co, Ko, Co, Co, Re^Vct, Gll, Gd^Fmf, Rb, Gd^Fp, Gd^Fp
Gd^Fmf, Mm, Mm, Mm, Mm, Hhd, Mm, Hhd, Gd^Fmf, Gd^Fmf, Gd^Es, Gd, Gd, Rb, Gll, Rb^Edt, Rb^Edt, Rb, Co, Co, Co, Rb, Ko, Rb, Rb, Rb, Rb^Vct, Rb^Edt, Rb^Edt, Gd^Edt, Gd^Vo, Gd^Es, Gll^Es, Gd, Rb^Edt, Gll^Edt, Rb, Rb, Re^Vct, Co, Re^Vct, Rb^Edt, Rb^Edt, Re^Vct, Gd^Fmf, Gd^Fdf, Gd^Fdf, Rb, Rb, Gd
Gd^Fmf, Gd^Fmf, Gd, Mm, Mm, Mm, Mm, Hhd, Hhd, Hhd, Gd^Fmf, Gd^Fmf, Gd^Fmf, Gd, Gd, Rb^Edt, Co, Rb^Vct, Co, Co, Co, Ko, 3 Ko, Ko, Co, Co, Co, Rb^Vct, Co, Rb^Edt, Rb^Edt, Rb, Rb^Edt, Rb^Edt, Gd, Rb, Gll^Edt, Gd^Fmf, Gd^Fmf, Re^Vct, Gd^Fmf, Rb^Fmf, Gd^Fmf, Rb^Fp, Gd^Fp, Gd^Fmf, Gd^Fdf, Gd^Fmf, Rb, Gd^Fp
Rb, Rb, Rb, Gd^Es, Hhd, Mm, Mm, Mm, Hhd, Hhd, Hhd, Hhd, Gd^Es, Gd, Rb, Rb^Edt, Rb^Edt, Rb^Vct, Rb^Vct, Co, Rb, Ko, Ko, Ko, Co, Co, Co, Rb^Vct, Rb, Rb, Rb, Gd^Fmf, Gd, Gd, Gd^Fp, Rb^Fmf, Gd^Fp, Gd^Fdf, Gd^_s, Gd^Fdf, Gd, Gd^Fmf, Gd^Fdf, Gd^Fmf, Gd^Fmf, Gd^Fmf, Gd^Fmf, Gd^Fmf, Gd^Fmf, Rb
Gd^Fmf, Gd^Fmf, Rb, Gd, Rb, Gd^Vo, Gd, Mm, Hhd, Hhd, Hhd, Hhd, Hhd, Gd, Rb, Rb, Rb^Edt, Co, Rb^Edt, Rb^Edt, Co, Rb, Rb, Rb, Rb^Vct, Co, Rb^Vct, Rb, Rb, Re, Gd^Fmf, Gd^Fmf, Gd, Gd^Fdf, Gd, Gd^Fmf, Gd^_s, Gd^_s, Gd^Fp, Gd^_s, Gd^_s, Gd^Fp, Gd^Fp, Gd^Fmf, Gd^Fp, Gd^Fmf, Gd^Fdf, Gd, Gd^Fmf, Gd^Fmf
Hhd, Gd^Fmf, Gd^Fmf, Rb, Gd, Rb, Rb, Gd^Es, Rb, Gd, Rb, Gd, Co, Gll, Rb, Gll, Gd, Rb^Edt, Gll, Rb^Edt, Rb, Co, Co, Co, Rb^Edt, Rb^Vct, Rb^Edt, Co, Rb, Gd^Fmf, Gd^Fdf, Gd^Fmf, Gd^Fmf, Gd^Fmf, Gd^Fp, Gd^_s, Gd^Fmf, Gd^Fmf, Gd^Es, Gd^Es, Gd^Fmf, Gd^_s, Gd^Fmf, Gd^Fmf, Gd^Fmf, Gd^Fp, Gd^Fp, Gd^Fp, Gd^Fdf, Gd^Fdf
Gd, Hhd, Hhd, Gd, Hhd, Gd^Es, Gd^Es, Rb, Gd, Rb, Gd, Rb, Rb, Rb, Gd, Hhd, Hhd, Gd, Gd, Gll, Rb, Rb^Edt, Rb^Edt, Rb^Edt, Rb^Edt, Co, Rb^Edt, Rb, Gd^Fmf, Gd, Gd^Feth, Gd^Fmf, Gd^Fdf, Gd^Fmf, Gd^Fmf, Gd^_s, Gd^Fdf, 2 Gd^Es, Gd^Es, 1 Gd^Es, Gd^Fmf, Gd^_s, Gd^Fdf, Gd^Fp, Gd^Fmf, Gd^Fdf, Gd^Fp, Gd^Fmf, Gd^Fmf, Gd^Fmf
Hhd, Hhd, Hhd, Hhd, Mm, Gd^Fmf, Hhd, Gd, Hhd, Gd^Vo, Hhd, Gd^Es, Co, Gd, Gd, Gd^Fmf, Hhd, Hhd, Hhd, Gd^Fmf, Gd^Fmf, Gll, Gd, Re, Rb^Edt, Rb^Edt, Re, Gd^Fmf, Gd^Fp, Gd^Fmf, Gd^Fmf, Gd^Fmf, Gd^Fmf, Gd^Fmf, Gd^Fmf, Gd^_s, Gd^Fmf, Gd^Es, Gd^Es, Gd^Es, Gd^Fp, Gd^_s, Gd^Fmf, Gd^Fmf, Gd^Fmf, Gd, Gd^Fmf, Gd^Fmf, Gd, Gd^Fmf
Mm, Mm, Mm, Hhd, Mm, Mm, Mm, Hhd, Mm, Hhd, Hhd, Hhd, Hhd, Hhd, Gd^Fmf, Gd^Fmf, Hhd, Hhd, Hhd, Gd^Fmf, Hhd, Gd, Gd, Re, Rb, Rb^Edt, Rb^Edt, Gll, Gd^Fmf, Gd^Fp, Gd^Fdf, Gd^Fmf, Gd^Fmf, Gd^Fmf, Gd^Fmf, Gd^_s, Gd^_s, Gd^Es, Gd^Es, Gd^Fmf, Gd^_s, Gd^_s, Gd^Fmf, Gd^Fmf, Gd^Fmf, Gd^Fmf, Gd^Fmf, Gd^Fmf, Gd^Fmf, Gd^Fmf
Hhd, Hhd, Hhd, Mm, Hhd, Mm, Hhd, Mm, Hhd, Mm, Hhd, Hhd, Hhd, Hhd, Hhd, Gd^Fmf, Gd^Fmf, Gd^Fmf, Gd^Fmf, Hhd, Hhd, Gd, Hhd, Gll, Rb, Rb^Edt, Rb^Edt, Gd^Fmf, Gd, Gd^Fmf, Gd^Fmf, Gd^Fdf, Gd^Fdf, Gd^Fmf, Gd^Fmf, Gd^Fmf, Gd^Fmf, Gd^_s, Gd^_s, Gd^_s, Gd^Fmf, Gd^Fdf, Gd^Fdf, Gd^Fmf, Gd^Fmf, Gd^Fp, Gd^Fp, Gd^Fmf, Gd^Fmf, Gd^Feth
Hhd, Hhd, Hhd, Hhd, Hhd, Hhd, Hhd, Hhd, Hhd, Hhd, Hhd, Hhd, Hhd, Hhd, Gd, Gd^Fmf, Gd, Gd^Fmf, Gd, Hhd, Hhd, Hhd, Hhd, Gll, Gll, Rb, Rb^Edt, Rb^Edt, Gd^Fmf, Gd^Fmf, Gd^Fmf, Gd^Fmf, Gd^Fmf, Gd^Fmf, Gd^Fmf, Gd^Fmf, Aa^Fp, Gd^Fdf, Gd^Fmf, Gd^Fmf, Gd^Fmf, Gd^Fdf, Gd^Fmf, Gd^Fmf, Gd^Fmf, Gd^Fp, Gd^Fmf, Gd^Fmf, Gd^Fmf, Gd^Fmf
