Hh, Mm^Xm, Mm^Xm, Mm^Xm, Mm^Xm, Mm^Xm, Mm^Xm, Mm^Xm, Mm^Xm, Mm^Xm, Mm^Xm, Mm^Xm, Mm^Xm, Mm^Xm, Mm^Xm, Mm^Xm, Mm^Xm, Mm^Xm, Mm^Xm, Mm^Xm, Mm^Xm, Mm^Xm, Mm^Xm, Mm^Xm, Mm^Xm, Mm^Xm, Mm^Xm, Hh, Mm, Hh, Mm, Hh, Mm, Mm^Xm, Mm^Xm, Mm^Xm, Mm^Xm, Mm^Xm, Mm^Xm, Mm^Xm, Mm^Xm, Mm^Xm, Mm^Xm, Mm^Xm, Mm^Xm, Mm^Xm, Mm^Xm, Mm^Xm, Mm^Xm, Mm^Xm
Mm^Xm, Mm^Xm, Mm^Xm, Mm^Xm, Mm^Xm, Mm^Xm, Mm^Xm, Mm^Xm, Mm^Xm, Mm^Xm, Mm^Xm, Mm^Xm, Mm^Xm, Mm^Xm, Mm^Xm, Mm^Xm, Mm^Xm, Mm^Xm, Mm^Xm, Mm^Xm, Mm^Xm, Mm^Xm, Mm^Xm, Mm^Xm, Mm^Xm, Mm^Xm, Mm^Xm, Mm, Mm, Mm, Mm, Mm, Mm, Mm^Xm, Mm, Mm^Xm, Mm^Xm, Mm^Xm, Mm^Xm, Mm^Xm, Mm^Xm, Mm^Xm, Mm^Xm, Mm^Xm, Mm^Xm, Mm^Xm, Mm^Xm, Mm^Xm, Mm^Xm, Mm^Xm
Mm^Xm, Mm^Xm, Mm^Xm, Mm^Xm, Mm^Xm, Mm^Xm, Mm^Xm, Mm^Xm, Mm^Xm, Mm^Xm, Mm^Xm, Mm^Xm, Mm^Xm, Mm^Xm, Mm^Xm, Mm^Xm, Mm^Xm, Mm^Xm, Mm, Mm^Xm, Mm, Mm^Xm, Mm, Mm, Mm, Mm, Mm, Mm, Mm, Mm, Mm, Mm, Mm, Mm, Mm, Mm, Mm, Mm^Xm, Mm, Mm^Xm, Mm, Mm^Xm, Mm^Xm, Mm^Xm, Mm^Xm, Mm^Xm, Mm^Xm, Mm^Xm, Mm^Xm, Mm^Xm
Mm^Xm, Mm^Xm, Mm^Xm, Mm^Xm, Mm^Xm, Mm^Xm, Mm^Xm, Mm^Xm, Mm^Xm, Mm^Xm, Mm, Mm^Xm, Mm^Xm, Mm^Xm, Mm^Xm, Mm^Xm, Mm^Xm, Mm^Xm, Mm, Mm, Mm, Mm, Mm, Mm, Mm, Mm, Mm^Xm, Mm, Mm^Xm, Mm^Xm, Mm^Xm, Mm, Mm^Xm, Mm, Mm, Mm, Mm, Mm, Mm, Mm, Mm, Mm^Xm, Mm^Xm, Mm^Xm, Mm^Xm, Mm^Xm, Mm^Xm, Mm^Xm, Mm^Xm, Mm
Mm^Xm, Mm^Xm, Mm^Xm, Mm^Xm, Mm^Xm, Mm^Xm, Mm^Xm, Mm^Xm, Mm, Mm, Mm, Mm^Xm, Mm, Mm^Xm, Mm, Mm, Mm^Xm, Mm, Mm, Mm, Mm, Mm, Mm, Mm, Mm, Mm, Mv, Mm^Xm, Cte^Vd, Cte^Vd, Cte^Vd, Mm^Xm, Mv, Mm, Mm, Mm, Mm, Mm, Mm, Mm, Mm, Mm^Xm, Mm^Xm, Mm^Xm, Mm^Xm, Mm^Xm, Mm^Xm, Mm^Xm, Mm, Mm
Mm^Xm, Mm^Xm, Mm^Xm, Mm^Xm, Mm^Xm, Mm^Xm, Mm, Mm, Mm, Mm, Cte^Vu, Mm, Mm, Mm, Mm, Mm, Mm, Mm, Mm, Mm, Mm, Mm, Hhd, Mm, Mm^Xm, Mm^Xm, Cte^Vd, Cte^Vd, Cf, Cf, Cf, Cte^Vd, Cte^Vd, Mm^Xm, Mm^Xm, Mm, Mm, Hhd, Hhd, Mm, Mm, Mm, Mm^Xm, Mm^Xm, Mm^Xm, Mm^Xm, Mm^Xm, Mm^Xm, Mm, Mm
Mm^Xm, Mm^Xm, Mm, Mm^Xm, Mm, Mm, Mm, Mm, Cte^Vu, Cte^Vu, 5 Kte, Cte^Vu, Cte^Vu, Mm, Mm, Mm, Mm, Mm, Mm, Hhd, Hhd, Hhd, Mm, Mm, Mm, Mv, Cte^Vd, Cte, Cf, 4 Cf^Kov, Cf, Cte, Cte^Vd, Mv, Mm, Mm, Hhd, Hhd, Hhd, Mm, Mm, Mm, Mm^Xm, Mm^Xm, Mm^Xm, Mm^Xm, Mm^Xm, Mm^Xm, Mm, Mm
Mm, Mm, Mm, Mm^Xm, Mm, Mm, Mm, Mm, Mm, Cte^Vu, Cte^Vu, Cte^Vu, Mm, Mm, Mm, Mm, Mm, Mm, Mm, Mm, Hhd, Gd^Fp, Hhd, Mm, Mm, Mm^Xm, Mv, Cte^Vd, Cte^Vd, Cf, Cte^Vd, Cte^Vd, Mv, Mm^Xm, Mm, Mm, Gd^Fdf, Mm, Hhd, Mm, Mm, Mm, Mm^Xm, Mm^Xm, Mm^Xm, Mm^Xm, Mm^Xm, Mm, Mm, Mm
Hhd, Mm, Mm, Mm, Mm, Mm, Mm, Mm, Mm, Mm, Mm, Mm, Mm, Mm, Mm, Mm, Rb, Mm, Mm, Mm, Hhd, Gd^Vo, Gd^Fdf, Mm, Mm, Mm, Mm, Mm, Mm^Xm, Cte^Vd, Mm^Xm, Mm, Mm, Mm, Mm, Hhd, Hhd, Hhd, Mm, Mm, Mm, Mm^Xm, Mm^Xm, Mm^Xm, Mm^Xm, Mm, Mm, Mm, Hhd^Fmf, Mm
Hhd, Mm, Mm, Mm, Mm, Mm, Hhd, Mm, Mm, Mm, Mm, Mm, Hhd, Mm, Mm, Mm, Hhd, Mm, Hhd, Mm, Hhd, Mm, Hhd, Rd, Rd, Mm, Rd, Rd, Mm, Mm^Xm, Mm, Mm, Mm, Mm, Mm, Hhd, Gd^Fp, Hhd, Mm, Mm, Mm^Xm, Mm^Xm, Mm^Xm, Mm^Xm, Mm, Mm, Mm, Hhd^Fmf, Hhd^Fmf, Mm
Hhd, Hhd, Hhd, Hhd^Fmf, Hhd, Mm, Hhd, Hhd, Gd^Fdf, Hhd, Hhd^Fmf, Hhd, Hhd^Fmf, Gd^Fdf, Hhd, Mm, Hhd, Hhd, Hhd, Hhd, Hhd, Hhd, Gd^Fp, Gd^Vo, Gd^Fdf, Rd, Rd, Rd, Mm, Mm, Mm, Mm, Hhd^Fmf, Hhd, Hhd, Hhd, Mm, Hhd^Fmw, Mm, Mm, Mm^Xm, Mm^Xm, Mm, Mm, Mm, Mm, Mm, Hhd^Fmf, Hhd^Fmf, Hhd^Fmf
Hhd, Hhd, Hhd, Hhd, Rd, Mm, Hhd, Hhd, Hhd, Rd, Hhd, Hhd, Rd, Hhd, Rd, Hhd^Fdf, Hhd, Mm, Hhd, Hhd, Hhd, Hhd, Hhd, Mm, Hhd, Rd, Hhd^Fmf, Hhd^Fmf, Hhd, Hhd, Rd, Hhd, Hhd, Mm, Hhd, Hhd^Fmf, Mm, Mm, Mm, Mm^Xm, Mm^Xm, Mm^Xm, Mm, Mm, Mm, Mm, Mm^Fmf, Mm, Hhd^Fmf, Hhd^Fmf
Mm, Hhd, Hhd, Rd, Mm, Hhd, Hhd, Hhd, Hhd, Hhd, Gd^Fp, Hhd, Mm, Hhd, Hhd, Hhd, Hhd, Hhd^Fdf, Gd^Fp, Hhd, Mm, Hhd, Hhd^Fmf, Gd^Fdf, Rd, Hhd, Hhd, Mm, Hhd^Fmf, Hhd, Hhd^Fmf, Rd, Hhd, Gd^Fdf, Mm, Hhd, Mm, Mm, Mm, Mm, Mm, Mm, Mm, Mm, Mm, Hhd^Fmf, Hhd^Fmf, Hhd^Fmf, Mm, Hhd^Fmf
Mm, Mm, Hhd, Hhd, Hhd, Rd, Hhd, Mm, Hhd, Rd, Hhd, Hhd, Hhd^Fmf, Mm, Hhd, Hhd, Hhd^Vo, Hhd, Hhd^Fdf, Hhd^Fdf, Hhd, Gd^Vo, Hhd^Fmf, Rd, Rd, Hhd, Hhd, Hhd, Hhd^Vo, Hhd, Rd, Rd, Hhd, Hhd, Hhd, Hhd, Mm, Mm, Mm, Mm, Hhd^Fmf, Mm, Hhd^Fmf, Mm, Hhd, Hhd^Fmf, Hhd, Mm, Mm, Mm
Hhd, Hhd, Hhd, Hhd, Gd^Fp, Hhd, Hhd, Gd^Fdf, Rd, Hhd, Hhd, Mm, Gd^Fdf, Hhd, Hhd, Hhd, Hhd, Hhd, Mm, Co, Co, Mm, Hhd, Hhd, Hhd, Hhd, Gd^Fp, Mm, Hhd, Gd^Fdf, Hhd^Fmf, Hhd, Hhd, Hhd, Mm, Mm, Mm, Mm, Mm, Mm, Hhd^Fmf, Hhd^Fmf, Hhd^Fmf, Mm, Hhd^Fmf, Hhd, Mm, Hhd^Fmf, Hhd, Mm
Hhd, Mm, Hhd, Hhd, Rd, Rd, Gd^Fdf, Hhd, Rd, Rd, Hhd, Hhd, Hhd, Rd, Hhd^Vo, Hhd, Hhd, Hhd, Rd, Hhd^Fdf, Rd, Gd, Hhd, Hhd, Mm, Gd^Fp, Hhd, Rd, Mm, Hhd, Hhd, Hhd, Hhd, Hhd^Fmf, Hhd^Fmf, Mm, Mm, Mm, Hhd^Fmf, Mm, Hhd, Rd, Hhd^Fdf, Hhd, Hhd, Hhd, Gd, Hhd, Hhd^Fmf, Hhd
Hhd, Hhd, Hhd, Hhd, Hhd, Rd, Hhd, Hhd, Hhd, Rd, Hhd^Fdf, Hhd, Hhd, Gd^Fdf, Mm, Hhd, Hhd, Hhd^Fmf, Hhd, Rd, Rd, Hhd, Hhd, Hhd, Gd^Fdf, Hhd, Hhd, Hhd, Rd, Mm, Hhd^Fdf, Gd^Vo, Hhd, Hhd, Hhd, Hhd^Fmf, Mm, Mm, Hhd^Fmf, Hhd^Fmf, Hhd, Hhd, Hhd, Hhd, Gd, Hhd, Re, Re, Hhd, Hhd
Hhd, Hhd, Hhd^Fdf, Hhd, Hhd, Hhd, Hhd, Hhd, Hhd, Hhd, Hhd, Hhd, Hhd, Hhd, Hhd, Hhd, Rd, Hhd, Hhd^Fmf, Hhd, Hhd^Fmf, Hhd, Hhd, Rd, Hhd, Hhd^Fdf, Hhd, Rd, Gd^Fp, Hhd, Hhd, Gd^Fp, Hhd, Hhd^Fdf, Rd, Hhd, Hhd, Hhd, Hhd, Hhd^Fp, Hhd, Rd, Gd^Es, Rd, Gd, Gd^Vo, Rb, 6 Gd, Re, Gd
Gd, Gd, Hhd, Gd, Gd, Gd, Hhd, Hhd, Hhd, Mm, Hhd, Hhd, Gd^Fdf, Gd^Fdf, Hhd, Hhd, Hhd, Gd^Fdf, Hhd, Hhd^Fmf, Hhd, Hhd, Hhd, Rd, Rd, Hhd, Aa^Fdf, Hhd, Rd, Rd, Hhd, Rd, Co, Co, Hhd, Hhd, Hhd, Hhd, Hhd, Hhd, Hhd, Gd^Es, Gd^Es, Gd^Es, Rb, Rb, Gd^Fmf, Rb, Rb, Rb
Gd, Gd, Gd^Es, Gd, Gd, Gd^Es, Gd^Edt, Gd, Gd, Gd, Hhd, Gd, Hhd, Hhd, Hhd, Hhd^Fmf, Hhd, Hhd, Hhd, Hhd, Hhd^Vo, Gd^Fp, Hhd, Hhd, Rd, Hhd, Hhd^Fdf, Hhd, Rd, Hhd, Gd^Fp, Mm, Ko, Hhd, Hhd, Hhd, Hhd, Hhd, Hhd, Rb^Fp, Gd^Es, Hhd, Gd, Rb, Gd, Gd^Fmf, Hhd, Gd^Fmf, Gd^Fdf, Gd^Fmf
Re, Gd^Es, Gd, Gd^Es, Rb^Vct, Rb^Edt, Rb^Edt, Gd^Edt, Rb, Gd^Vo, Rb, Gd, Gd, Hhd, Rd, Rd, Gd, Gd, Hhd, Hhd, Re, Mm, Gd^Fp, Hhd, Hhd^Fdf, Mm, Hhd, Hhd, Hhd, Hhd, Hhd, Hhd, Hhd, Hhd, Hhd, Hhd, Hhd, Hhd, Hhd^Fdf, Hhd, Gd, Gd, Rb, Rb, Gd, Gd^Fmf, Mm, Hhd, Mm, Hhd
Rb, Rb^Edt, Rb^Edt, Rb^Vct, Co, Co, Co, Rb^Edt, Gd^Edt, Gd, Rb, Gd, Gd, Hhd, Rd, Rd, Gd^Es, Gd, Gd^Vo, Re, Gd^Vo, Hhd, Hhd, Hhd, Hhd, Mm, Hhd, Hhd, Gd^Fdf, Hhd, Mm, Hhd, Hhd, Hhd, Hhd, Rb^Vo, Hhd, Hhd, Hhd, Gd^Vo, Re, Rb, Rb, Gd, Gd^Fp, Hhd, Hhd, Mm, Mm, Mm
Gd, Rb^Edt, Re, Rb^Vct, Co, Co, Ko, Rb, Rb, Re, Gd^Edt, Gd, Gd^Es, Gd, Re, Gd^Es, Gd^Es, Gd^Es, Gd, Hhd, Re, Hhd, Hhd, Hhd, Hhd, Hhd, Hhd, Hhd, Hhd, Hhd, Hhd, Hhd, Gd, Hhd^Fmw, Hhd, Hhd, Hhd^Vo, Mm, Hhd^Fdf, Hhd, Gd, Gd, Rb, Gd^Fmf, Hhd, Hhd, Hhd, Mm, Mm, Mm
Mm, Gd, Gd, Rb, Rb, Ko, Ko, Co, Co, Rb^Edt, Rb^Edt, Gd^Es, Gd, Gd^Es, Gd^Vo, Gd^Es, Gd^Es, Gd, Hhd, Mm, Hhd, Hhd, Hhd, Re, Gd, Hhd, Gd^Fp, Hhd, Hhd, Hhd, Gd^Fp, Hhd, Hhd, Hhd, Hhd, Hhd, Mm, Hhd, Rd, Gd^Es, Gd, Rb, Rb, Gd^Fmf, Gd^Fmf, Gd^Fp, Hhd, Hhd, Mm, Mm
Mm, Re, Hhd, Re, Gd, Rb, Co, Co, Co, Rb^Vct, Gd, Gd^Es, Gd^Vo, Gd^Es, Re, Rb, Gd^Es, Gd^Es, Hhd, Hhd, Mm, Gd, Gd^Es, Rb, Gd, Hhd, Hhd^Fdf, Mm, Mm, Hhd, Re, Gd, Gd^Es, Hhd, Rd, Hhd, Hhd, Mm, Gd, Gd^Es, Re, Rb, Gd^Fmf, Gd^Fp, Gd^Fdf, Gd^Fdf, Gd^Fmf, Hhd, Hhd, Mm
Mm, Hhd^Fdf, Hhd, Re, Mm, Rb, Rb, Co, Rb^Vct, Rb^Vct, Hhd, Gd, Gd^Edt, Rb, Gd, Gd^Es, Gd, Gd^Es, Gd, Gd, Rb, Gd, Gd, Gd^Es, Gd^Es, Hhd^Vo, Hhd, Hhd, Hhd, Gd^Fp, Hhd, Gd^Es, Gd^Es, Gd, Gd, Hhd^Fmw, Hhd, Hhd, Gd^Vo, Gd^Es, Gd, Rb, Rb^Edt, Gd^Fmf, Gd^Fmf, Gd^Fmf, Gd^Fp, Gd^Fmf, Hhd, Hhd
Hhd, Hhd^Fdf, Hhd, Hhd^Fdf, Hhd, Hhd, Hhd^Fdf, Rb, Hhd, Rb, Rb, Rb, Gd^Edt, Gd^Edt, Rb, Gd^Vo, Gd, Rb, Rb, Rb, Rb, Gd, Rb, Hhd, Rb, Gd, Gd^Es, Rb, Hhd, Mm, Hhd, Gd, Gd, Gd^Es, Gd, Hhd, Rb, Gd^Fdf, Rb^Edt, Rb^Edt, Rb, Rb^Edt, Co, Rb^Edt, Rb^Edt, Gd^Fmf, Gd^Fmf, Gd^Fp, Gd, Hhd
Hhd, Hhd, Mm, Hhd^Fdf, Hhd, Hhd^Fdf, Mm, Mm, Rb, Gd, Rb, Rb^Edt, Rb^Edt, Gd^Edt, Gd, Gd, Rb, Rb, Rb, Co, Rb, Rb, Co, Rb, Rb, Gd^Es, Rb, Gd, Gd, Hhd, Hhd, Hhd, Rb, Gd, Hhd, Re, Gd^Es, Rb, Co, Co, Ko, Ko, Co, Co, Re^Vct, Rb^Edt, Rb, Gd^Feth, Gd^Fp, Gd^Fp
Hhd, Hhd, Mm, Hhd, Hhd^Fdf, Hhd^Fdf, Hhd^Fdf, Hhd^Fdf, Gd^Vo, Rb, Gd^Edt, Rb^Edt, Rb, Gd^Edt, Rb, Re, Rb^Edt, Co, Rb^Vct, Rb^Vct, Rb^Vct, Co, Rb, Co, Co, Rb, Co, Rb^Edt, Gd^Edt, Re, Gd^Es, Gd^Es, Re, Gd, Re, Gd, Gd^Edt, Rb, Co, Co, Co, Ko, Co, Co, Re^Vct, Gd, Gd^Fmf, Rb, Gd^Fp, Gd^Fp
Hhd^Fdf, Hhd, Hhd^Fdf, Hhd^Fdf, Mm, Hhd, Gd, Rb, Gd^Edt, Gd^Edt, Rb, Rb, Gd^Vo, Rb, Gd, Rb^Edt, Rb^Edt, Rb, Co, Co, Co, Rb, Ko, Rb, Rb, Rb, Rb^Vct, Rb^Edt, Rb^Edt, Gd^Edt, Gd^Vo, Gd^Es, Gd^Es, Gd, Rb^Edt, Gd^Edt, Rb, Rb, Re^Vct, Co, Re^Vct, Rb^Edt, Rb^Edt, Re^Vct, Gd^Fmf, Gd^Fdf, Gd^Fdf, Rb, Rb, Gd
Mm, Hhd, Hhd, Hhd, Re^Fdf, Mm, Re^Fdf, Gd, Gd^Es, Gd^Edt, Hhd, Gd, Gd^Es, Gd^Es, Rb, Rb^Edt, Co, Rb^Vct, Co, Co, Co, Ko, 3 Ko, Ko, Co, Co, Co, Rb^Vct, Co, Rb^Edt, Rb^Edt, Rb, Rb^Edt, Rb^Edt, Rb^Edt, Rb, Gd^Edt, Gd^Fmf, Gd^Fmf, Re^Vct, Gd^Fmf, Rb^Fmf, Gd^Fmf, Rb^Fp, Gd^Fp, Gd^Fmf, Gd^Fdf, Gd^Fmf, Rb, Gd^Fp
Hhd, Mm, Mm, Hhd, Hhd^Fdf, Re^Fdf, Re, Gd^Es, Mm, Rb, Re, Gd, Gd^Es, Gd^Es, Gd^Edt, Rb^Edt, Rb^Edt, Rb^Vct, Rb^Vct, Co, Rb, Ko, Ko, Ko, Co, Co, Co, Rb^Vct, Rb, Rb, Rb, Gd^Fmf, Gd, Rb^Edt, Gd^Fp, Rb^Fmf, Gd^Fp, Gd^Fdf, Gd^_s, Gd^Fdf, Gd, Gd^Fmf, Gd^Fdf, Gd^Fmf, Gd^Fmf, Gd^Fmf, Gd^Fmf, Gd^Fmf, Gd^Fmf, Rb
Mm, Mm, Mm, Hhd^Fdf, Hhd, Hhd^Fdf, Hhd^Fdf, Mm, Hhd^Fdf, Gd, Hhd, Re, Gd, Gd^Edt, Rb, Gd^Edt, Rb^Edt, Co, Rb^Edt, Rb^Edt, Co, Rb, Rb, Rb, Rb^Vct, Co, Rb^Vct, Rb, Rb, Re, Gd^Fmf, Gd^Fmf, Gd, Gd^Fdf, Gd, Gd^Fmf, Gd^_s, Gd^_s, Gd^Fp, Gd^_s, Gd^_s, Gd^Fp, Gd^Fp, Gd^Fmf, Gd^Fp, Gd^Fmf, Gd^Fdf, Gd, Gd^Fmf, Gd^Fmf
Mm, Mm, Hhd^Fdf, Hhd^Fdf, Hhd^Fdf, Mm, Mm, Mm, Mm, Hhd^Fdf, Hhd^Fdf, Re, Rb, Gd, Re, Gd, Rb, Rb^Edt, Gd^Edt, Rb^Edt, Rb, Co, Co, Co, Rb^Edt, Rb^Vct, Rb^Edt, Co, Rb, Gd^Fmf, Gd^Fdf, Gd^Fmf, Gd^Fmf, Gd^Fmf, Gd^Fp, Gd^_s, Gd^Fmf, Gd^Fmf, Gd^Es, Gd^Es, Gd^Fmf, Gd^_s, Gd^Fmf, Gd^Fmf, Gd^Fmf, Gd^Fp, Gd^Fp, Gd^Fp, Gd^Fdf, Gd^Fdf
Mm, Mm, Mm, Hhd^Fdf, Hhd^Fdf, Hhd^Fdf, Re, Hhd^Fdf, Hhd, Hhd^Fdf, Hhd, Rb, Mm, Hhd^Feth, Hhd, Gd, Rb, Gd, Gd^Es, Gd, Gd^Es, Rb^Edt, Rb^Edt, Rb^Edt, Rb^Edt, Co, Rb^Edt, Rb, Gd^Fmf, Gd, Gd^Feth, Gd^Fmf, Gd^Fdf, Gd^Fmf, Gd^Fmf, Gd^_s, Gd^Fdf, 2 Gd^Es, Gd^Es, 1 Gd^Es, Gd^Fmf, Gd^_s, Gd^Fdf, Gd^Fp, Gd^Fmf, Gd^Fdf, Gd^Fp, Gd^Fmf, Gd^Fmf, Gd^Fmf
Mm, Mm, Mm, Mm, Mm, Hhd^Fdf, Hhd^Fdf, Mm, Mm, Hhd^Fdf, Hhd, Hhd, Hhd, Hhd, Hhd, Gd, Gd, Gd^Es, Rb, Gd^Es, Gd^Es, Gd, Gd, Re, Rb^Edt, Rb^Edt, Re, Gd^Fmf, Gd^Fp, Gd^Fmf, Gd^Fmf, Gd^Fmf, Gd^Fmf, Gd^Fmf, Gd^Fmf, Gd^_s, Gd^Fmf, Gd^Es, Gd^Es, Gd^Es, Gd^Fp, Gd^_s, Gd^Fmf, Gd^Fmf, Gd^Fmf, Gd, Gd^Fmf, Gd^Fmf, Gd, Gd^Fmf
Mm, Mm, Hhd^Fdf, Mm, Hhd^Fdf, Mm, Hhd, Hhd, Hhd, Hhd, Hhd, Hhd^Fdf, Hhd^Fdf, Hhd, Hhd, Gd, Hhd^Fdf, Rb, Rb, Gd, Gd^Es, Gd^Es, Gd^Es, Re, Hhd, Rb^Edt, Rb^Edt, Gd, Gd^Fmf, Gd^Fp, Gd^Fdf, Gd^Fmf, Gd^Fmf, Gd^Fmf, Gd^Fmf, Gd^_s, Gd^_s, Gd^Es, Gd^Es, Gd^Fmf, Gd^_s, Gd^_s, Gd^Fmf, Gd^Fmf, Gd^Fmf, Gd^Fmf, Gd^Fmf, Gd^Fmf, Gd^Fmf, Gd^Fmf
Mm, Mm, Mm, Hhd^Fdf, Hhd^Feth, Hhd^Fdf, Hhd^Fdf, Mm, Hhd^Fdf, Re, Mm, Hhd, Hhd, Re, Hhd^Fdf, Hhd, Hhd, Mm, Gd, Gd, Rb, Gd^Es, Gd, Gd^Es, Gd, Rb^Edt, Rb^Edt, Gd^Fmf, Gd, Gd^Fmf, Gd^Fmf, Gd^Fdf, Gd^Fdf, Gd^Fmf, Gd^Fmf, Gd^Fmf, Gd^Fmf, Gd^_s, Gd^_s, Gd^_s, Gd^Fmf, Gd^Fdf, Gd^Fdf, Gd^Fmf, Gd^Fmf, Gd^Fp, Gd^Fp, Gd^Fmf, Gd^Fmf, Gd^Feth
Mm, Mm, Hhd, Hhd, Mm, Mm, Hhd, Re, Hhd, Hhd, Hhd^Fdf, Hhd^Fdf, Hhd, Hhd, Mm, Hhd^Fdf, Hhd, Hhd, Mm, Hhd, Gd, Gd, Gd^Esa, Gd, Gd, Gd, Rb^Edt, Rb^Edt, Gd^Fmf, Gd^Fmf, Gd^Fmf, Gd^Fmf, Gd^Fmf, Gd^Fmf, Gd^Fmf, Gd^Fmf, Aa^Fp, Gd^Fdf, Gd^Fmf, Gd^Fmf, Gd^Fmf, Gd^Fdf, Gd^Fmf, Gd^Fmf, Gd^Fmf, Gd^Fp, Gd^Fmf, Gd^Fmf, Gd^Fmf, Gd^Fmf
