Xoc, Xoc, Xoc, Xoc, Xoc, Xoc, Xoc, Xoc, Rr^_s, Xoc, Xoc, Xoc, Xoc, Xoc, Xoc, Xoc, Xoc
Xoc, Xoc, Xoc, Xoc, Xoc, Xoc, Xoc, Xoc, Rr^_s, Xoc, Xoc, Xoc, Xoc, Xoc, Xoc, Xoc, Xoc
Xoc, Xoc, Xoc, Xoc, Xoc, Xoc, Ias, Xoc^Efs, Rr^Pr|o, Xoc^Efs, Ias, Xoc, Xoc, Xoc, Xoc, Xoc, Xoc
Xoc, Xoc, Xoc, Xoc, Ias, Rr, Ias, Ias, Ias, Ias, Ias, Ias, Ias, Xoc, Xoc, Xoc, Xoc
Xoc, Xoc, Xoc, Xoc, Ias, Ias, Xoc^Efs, Ias, Ias, Ias, Xoc^Efs, Ias, Ias, Xoc, Xoc, Xoc, Xoc
Xoc, Xoc, Xoc, Xoc^Efs, Ias, Ias, Ias, Rr, Ias, Ias, Ias, Rr, Ias, Xoc^Efs, Xoc, Xoc, Xoc
Xoc, Xoc, Xoc, Ias, Ias, Ias, Ias, 1 Ias, Ias, 2 Ias, Ias, Ias, Ias, Ias, Xoc, Xoc, Xoc
Xoc, Xoc, Xoc, Xos, Ias, Ias, Ias, Ias, Ias, Ias, Ias, Ias, Rr, Xoc, Xoc, Xoc, Xoc
Xoc, Xoc, Xoc, Xoc, Ias, Rr, Xoc^Efs, Ias, Ias, Ias, Xoc^Efs, Ias, Ias, Xoc, Xoc, Xoc, Xoc
Xoc, Xoc, Xoc, Xoc, Ias, Ias, Ias, Ias, Ias, Ias, Rr, Ias, Ias, Xoc, Xoc, Xoc, Xoc
Xoc, Xoc, Xoc, Xoc, Xoc, Ias, Rr, Ias, Ias, Ias, Ias, Ias, Xoc, Xoc, Xoc, Xoc, Xoc
Xoc, Xoc, Xoc, Xoc, Xoc, Xoc, Xoc, Xoc, Xoc, Xoc, Xoc, Xoc, Xoc, Xoc, Xoc, Xoc, Xoc
Xoc, Xoc, Xoc, Xoc, Xoc, Xoc, Xoc, Xoc, Xoc, Xoc, Xoc, Xoc, Xoc, Xoc, Xoc, Xoc, Xoa
