Mm, Mm, Hhd, Gd, Gll^Fdf, Gll^Fdf, Gll^Fdf, Gll^Fdf, Gll^Fdf, Gll^Fdf, Hhd^Fmf, Hhd, Mm, Mm, Mm, Mm, Mm, Gd, Aa, Gd, Gd, Gd, Gd, Gd, Gd, Gd, Ai, Ai, Wog, Wog, Wog, Ai, Gd^Fdf, Gd^Fdf, Gd^Fdf, Gd, Gll, Gd, Gd, Gd, Gd, Gd, Gll, Gd^Fdf, Gd^Fdf, Gd
Mm, Mm, Hhd, Hhd^Fmf, Hhd^Fmf, Gll^Fdf, Hhd^Fmf, Gll^Fdf, Gll^Fdf, Gll^Fdf, Hhd^Fmf, Hhd, Hhd, Mm, Mm, Mm, Hhd, Hhd, Hhd, Gd, Aa, Aa, Hhd, Gd^Es, Gd, Ai, Ai, Wwg, Wog, Wog, Ai, Ai, Ai, Gd^Fdf, Gd^Fdf, Gd^Fdf, Gd, Gd, 3 Gd, Gd, Gd, Gll, Gd^Fdf, Gd^Fdf, Gd^Fdf, Gd^Fdf
Mm, Hhd, Mm, Hhd, Hhd^Fmf, Hhd^Fmf, Hhd^Fmf, Gll^Fdf, Gll^Fdf, Gll^Fdf, Gll^Fdf, Hhd^Fmf, Hhd^Fmf, Mm, Mm, Mm, Hhd, Hhd, Hhd, Gll, Aa, Aa, Hhd, Hhd, Gd^Es, Gd, Gd, Wwg, Wog, Wwg, Gd, Gll, Gd^Fdf, Gd^Fdf, Gd^Fdf, Gd, Gd, Gd, Gd, Gd, Gd, Gll, Gd^Fdf, Gd^Fdf, Gd^Fdf, Gll
Mm, Mm, Mm, Mm, Mm, Hhd, Hhd, Gll^Fmf, Gll^Fdf, Gll^Fdf, Gll^Fdf, Gll^Fdf, Hhd, Hhd, Mm, Hhd, Hhd^Fmf, Hhd^Fmf, Gll^Fdf, Gll, Hhd^Fmf, Hhd, Hhd, Aa, Aa, Gd, Wwg, Wwg, Wwg, Gd, Gll, Gll, Hhd, Hhd, Gd^Fdf, Gll, Gd, Gd, Gd^Gvs, Gd, Gd, Gll, Gll, Gll, Gll, Gll
Mm, Mm, Mm, Mm, Hhd, Hhd, Hhd^Fmf, Hhd^Fmf, Gd^Vhr, Gll^Fdf, Gll, Aa, Hhd, Hhd, Hhd, Hhd, Hhd^Fmf, Gll^Fdf, Gll^Fdf, Gll^Fdf, Hhd, Mm, Mm, Hhd, Gd, Gd^Es, Wwg, Wwg, Wwg, Ai, Gll, Gd^Fdf, Gd^Fdf, Hhd, Hhd, Gll, Gd, Gd^Gvs, Gd^Gvs, Gd^Gvs, Gd, Gd, Gd, Gd, Gd, Gd
Mm, Mm, Hhd, Mm, Mm, Hhd, Hhd, Hhd, Gll, Gll^Fdf, Aa, Hhd, Hhd, Mm, Mm, Hhd, Hhd, Gll^Fdf, Gll^Fdf, Gll^Fdf, Hhd^Fmf, Mm, Hhd, Hhd, Gd^Es, Gd, Ai, Wwg, Wwg, Wwg, Gll, Gd^Fdf, Gll, Hhd, Gll, Hhd, Gd, Gd, Gll, Gll, Gll, Gd, Gd^Gvs, Gd^Gvs, Gd^Gvs, Gd
Hhd, Hhd, Hhd, Mm, Hhd, Hhd, Hhd, Aa, Gd, Aa, Aa, Hhd, Hhd, Hhd, Hhd, Hhd, Gll, Gll^Fdf, Gll^Fdf, Hhd^Fmf, Hhd^Fmf, Hhd, Aa, Hhd, Gd, Gd, Ai, Wwg, Wwg, Wwg, Gd, Gll, Gll, Gll, Gd^Fdf, Gll, Gll, Gd, Hhd, Gd^Fdf, Gll, Gd, Gd, Gd^Gvs, Gd^Gvs, Gd
Hhd, Hhd, Hhd, Hhd, Hhd^Fmf, Hhd^Fmf, Gll^Fdf, Gll, Gll, Gd^Es, Gd, Hhd, Hhd, Hhd, Gd, Hhd, Gd^Es, Gll^Fdf, Aa, Hhd, Hhd, Hhd, Aa, Aa, Gd, Gd, Wwg, Wwg, Wwg, Gd, Gd, Gd, Hhd, Gd^Fdf, Hhd, Gd^Fdf, Gll, Gd, Hhd, Hhd, Gd^Fdf, Gll, Gd, Gd, Gd, Gd
Hhd, Hhd, Hhd, Hhd, Hhd^Fmf, Hhd^Fmf, Gll^Fdf, Gll^Fdf, Hhd, Hhd, Aa, Gd, Gd, Gd, Gd^Vo, Gd, Gd, Aa, Hhd, Hhd, Hhd, Aa, Gd^Es, Gd, Gd, Co, Wwg, Wwg, Ai, Gd, Gll^Fdf, Gd, Hhd, Hhd, Hhd, Gll, Gd, Gd, Gll, Gd^Fdf, Gd^Fdf, Gll, Gd, Gd, Gd, Gd
Hhd, Hhd, Hhd, Hhd, Gll^Fdf, Gll^Fdf, Gll^Fdf, Gll^Fdf, Mm, Hhd, Gll, Gd, Gd, Gd, Gd, Gd, Gd, Hhd, Hhd, Hhd, Hhd, Gd^Es, Gd, Gd, Ai, Wwg, Wog, Wwg, Gd, Gd, Hhd, Gd^Fdf, Gll, Gd, Gd, Gd^Vhr, Gd^Gvs, Gd^Gvs, Gd, Gll, Gll, Gll, Gd^Gvs, Gd^Gvs, Gd^Gvs, Gd
Gd, Gd^Es, Aa, Aa, Gll, Gll, Hhd, Hhd^Fmf, Hhd, Hhd, Gd, Gd, Gd, Gd, Gd, Gd, Gd, Gd, Co, Co, 1 Ko, Gd, Gd, Ai, Wwg, Wwg, Wog, Wwg, Gd, Gll, Gd^Fdf, Gd^Fdf, Gll, Gd, Gd, Gd^Gvs, Gd^Gvs, Gd^Gvs, Gd^Gvs, Gd, Gd, Gd, Gd^Gvs, Gd^Gvs, Gd^Gvs, Gd
Gd, Gd^Es, Gd, Gd, Gd^Es, Hhd, Gd, Hhd, Gd, Hhd, Re^Edt, Co, Re, Gd, Re, Co, Re, Gd, Co, Co, Co, Gd, Gd, Ai, Wwg, Wog, Wwg, Ai, Ai, Gll, Gll, Gll, Re, Re, Re, Gd^Gvs, Co, Gd, Re, Re, Re, Gd, Gd, Gd, Gd, Gd
Rb, Gd, Rb, Gd^Vhr, Rb, Gd, Rb, Gd, Rb, Re^Vo, Rb^Edt, Rb^Edt, Rb, Rb, Rb, Rb^Edt, Rb, Re^Vo, Rb, Co, Rb, Gd, Wwg^Bp\, Wwg, Co, Co, Co, Ai, Wwg^Bp/, Gd, Rb, Gd, Re, Co, Re, Re^Vct, Rb, Re, Re, Co, Re, Gd, Rb, Gd, Rb^Edt, Gd
Rb^Edt, Rb, Rb^Edt, Rb, Rb, Rb, Rb^Edt, Rb, Rb^Edt, Rb, Rb, Rb, Rb, Rb, Rb, Rb^Edt, Rb, Rb, Rb, Rb^Edt, Rb^Edt, Rb^Edt, Wwg^Bp\, Rb^Edt, Rb^Es, Rb^Vct, Rb^Es, Rb^Edt, Wwg^Bp/, Rb, Rb, Rb^Edt, Rb^Edt, Re^Edt, Rb^Edt, Rb, Rb, Rb, Rb^Edt, Re^Edt, Rb^Edt, Rb, Rb, Rb^Edt, 2 Rb^Edt, Rb^Edt
Gd, Rb^Edt, Gd, Rb, Gd, Rb^Edt, Gd, Rb^Edt, Gd, Rb, Re, Co, Re, Rb, Re, Co, Re, Rb, Gd^Vo, Rb, Gd, Rb, Wwg^Bp/, Rb, Co, Rb^Vct, Co, Rb^Es, Wwg^Bp\, Rb, Gd, Rb, Re, Re, Re, Rb, Co, Rb^Vct, Re, Re, Re, Rb, Gll, Rb, Gd^Fdf, Rb
Gd, Gd, Gd, Gd, Gd, Gd, Gd, Gd, Gd, Gd, Gd, Re, Gd, Gd^Vo, Gd, Re, Gd, Gd, Gd, Gd, Gd, Gd, Ai, Wwg, Wog, Co, Ai, Ai, Gd, Gd, Gd^Gvs, Gd, Re, Co, Re, Re, Gd, Re, Re, Co, Re, Gd, Gll, Gd^Fdf, Gd^Fdf, Gd^Fdf
Hhd, Gd, Gd, Gd, Hhd, Gd, Hhd, Gd, Hhd, Gd, Gd, Gd, Gd^Es, Gd, Hhd, Gd^Es, Hhd, Hhd, Hhd, Hhd, Hhd, Gd, Gd, Wwg, Wog, Wwg, Gd, Ai, Gd^Gvs, Gd^Gvs, Gd, Gd, Gd, Re, Gd, Gd, Gd^Gvs, Gd^Gvs, Gd, Re, Gd, Gll, Gd^Fdf, Gd^Fdf, Gd^Fdf, Gd^Fdf
Hhd, Hhd, Hhd, Hhd, Mm, Hhd, Hhd, Hhd, Aa, Gd, Gd, Gd, Hhd, Hhd, Hhd, Hhd, Mm, Mm, Hhd^Fmf, Hhd, Hhd, Gd, Wwg, Wog, Wwg, Gd, Gd, Gd, Gd^Gvs, Gd^Gvs, Gll, Gd, Gd, Gd, Gd, Gd^Gvs, Gd^Gvs, Gd^Gvs, Gd^Gvs, Gd, Gd, Gll, Gll, Gll, Gll, Gll
Hhd, Hhd, Hhd, Mm, Hhd^Fmf, Mm, Hhd, Hhd, Aa, Aa, Gd^Es, Hhd, Hhd, Mm, Gll^Fdf, Hhd^Fmf, Gll^Fdf, Mm, Gll^Fdf, Gll, Gd, Co, Wwg, Wwg, Ai, Gd, Gd^Gvs, Gd, Gll, Gll, Gd^Fdf, Hhd, Gd, Gd, Gd, Gd^Gvs, Gd, Gd^Gvs, Gd, Gd, Gll, Gd, Gll, Gd, Gd, Gd
Gll^Fdf, Gll^Fdf, Gll^Fdf, Hhd^Fmf, Gll^Fdf, Hhd^Fmf, Gll^Fdf, Hhd, Hhd, Hhd, Gd, Hhd, Gll, Gll^Fdf, Gll^Fdf, Gll^Fdf, Gll^Fdf, Gll^Fdf, Aa, Gll^Es, Gd, Wwg, Wwg, Wwg, Gd, Gd, Gd^Gvs, Gd, Gll, Gd^Fdf, Hhd, Hhd, Hhd, Gd, Gd, Gd, Gd, Gd, Gll, Gd^Vhr, Gd^Fdf, Gll, Gd^Fdf, Gll, Gd, Gd
Gll^Fdf, Gll^Fdf, Gll^Fdf, Gll^Fdf, Gll^Fdf, Gll^Fdf, Hhd, Hhd, Hhd, Hhd, Gd^Es, Gd, Hhd, Hhd^Fmf, Mm, Hhd^Fmf, Mm, Gll^Fdf, Hhd^Fmf, Gd, Gd, Wwg, Wwg, Ai, Ai, Gd^Gvs, Gd^Gvs, Gd, Gd, Hhd, Hhd, Hhd, Gd^Fdf, Hhd, Gd, Gd, Gd, Gd, Gll, Gd^Fdf, Gd^Fdf, Gd^Fdf, Gll, Gll, Gd, Gd
Gll^Fdf, Gll^Fdf, Gll^Fdf, Gll^Fdf, Hhd^Fmf, Hhd^Fmf, Hhd, Hhd, Hhd, Aa, Aa, Gd^Es, Hhd, Hhd, Hhd, Mm, Mm, Hhd, Gd^Es, Hhd, Gd, Wwg, Wwg, Wwg, Wwg, Gd, Gd, Gd, Gll, Gll, Gd^Fdf, Gd^Fdf, Gd^Fdf, Hhd, Gll, Gd, Gd^Gvs, Gd, Gd^Gvs, Gll, Gll, Gd^Fdf, Gll, Gd, Gd, Gd
Hhd, Hhd^Fmf, Gll^Fdf, Gll^Fdf, Gll^Fdf, Gll^Fdf, Hhd, Mm, Hhd, Hhd, Gd^Vhr, Gd, Gll^Fdf, Gll^Fdf, Hhd^Fmf, Hhd, Aa, Hhd, Aa, Gd^Es, Gd, Gd, Ai, Wwg, Wwg, Gd, Gll, Gll, Gd^Fdf, Gll, Gd^Fdf, Gd^Fdf, Gd^Fdf, Gd^Fdf, Gll, Gd, Gd^Gvs, Gd^Gvs, Gd^Gvs, Gd, Gd, Gll, Gd, Gd, Gll, Gll
Hhd, Hhd, Hhd, Hhd, Hhd^Fmf, Hhd^Fmf, Mm, Mm, Hhd, Hhd, Gll, Gll, Gll^Fdf, Gll^Fdf, Hhd^Fmf, Hhd, Gll^Fdf, Aa, Gd^Es, Gd, Gd, Ai, Wwg, Wwg, Wwg, Gd, Aa, Gd^Fdf, Gd^Fdf, Hhd, Hhd, Hhd, Gd^Fdf, Gd^Fdf, Gll, Gd, Gd, Gd^Gvs, Gd, Gd, Gd, Gd, Gd, Gll, Gd^Fdf, Gd^Fdf
Mm, Mm, Mm, Mm, Mm, Mm, Hhd, Hhd, Aa, Hhd, Gd, Gll, Aa, Hhd, Gll^Fdf, Hhd, Gll^Fdf, Aa, Gll, Gd, Ai, Wwg, Wog, Wog, Gd, Gd, Hhd, Gd^Fdf, Hhd, Hhd, Hhd, Hhd, Gd^Fdf, Gd^Fdf, Gd^Fdf, Gll, Gd, Gd, Gd, Gd, Gd, Gd, Gll, Gll, Gd^Fdf, Gd^Fdf
Mm, Mm, Mm, Mm, Hhd, Hhd, Hhd, Aa, Aa, Gd^Es, Gd, Aa, Aa, Gll^Fdf, Gll^Fdf, Gll^Fdf, Gll^Fdf, Gll^Fdf, Gll^Fdf, Ai, Ai, Wwg, Wog, Ai, Ai, Gd, Aa, Hhd, Aa, Hhd, Hhd, Hhd, Hhd, Hhd, Gd^Fdf, Gd^Fdf, Gll, Gd, Gd, Gd, Gd, Gd, Gll, Gd^Fdf, Gd^Fdf, Gd^Fdf
Hhd, Mm, Gd, Hhd, Gd, Hhd, Gd, Aa, Gd, Gd, Gd, Gll, Gll^Fdf, Gll^Fdf, Gll^Fdf, Gll^Fdf, Gll^Fdf, Gll^Fdf, Gll^Fdf, Ai, Wwg, Wog, Wog, Wog, Ai, Ai, Wwg, Gd, Gll, Hhd, Hhd, Hhd, Hhd, Hhd, Hhd, Hhd, Gll, Gd, Gd, Gd, Gd, Gd, Gd, Gll, Gd^Fdf, Gd^Fdf
