Mm, Mm, Mm, Mm, Mm, Mm, Mm, Mm, Mm, Mm, Ms, Mm, Mm, Mm, Mm, Mm, Ms, Mm, Hhd, Hhd, Hhd, Hhd, Gd, Gd, Gd, Gd, Ai, Ai, Wog, Wog, Wog, Ai, Gd^Fdf, Gd^Fdf, Gd^Fdf, Gd, Gll, Gd, Rb, Gd, Gd, Gd, Gll, Gd^Fdf, Gd^Fdf, Gd
Ms, Ms, Mm, Mm, Wwg, Mm, Hhd, Hhd, Hhd, Mm, Mm, Ms, Hhd, Mm, Hhd, Mm, Mm, Ms, Mm, Hhd, Gd^Es, Gd, Aa, Gll, Aa, Ai, Ai, Wwg, Wog, Wog, Ai, Ai, Ai, Gd^Fdf, Gd^Fdf, Gd^Fdf, Gd, Gd, 3 Ke, Rb, Rb, Gll, Gd^Fdf, Gd^Fdf, Gd^Fdf, Gd^Fdf
Ms, Mm, Wwg, Mm, Wwg, Ai, Ms, Ms, Aa, Aa, Mm, Mm, Mm, Hhd, Hhd, Hhd, Hhd^Vhhr, Mm, Hhd, Mm, Gd^Es, Aa, Hhd, Aa, Gll, Gd, Gd, Wwg, Wog, Wwg, Gd, Gll, Gd^Fdf, Gd^Fdf, Gd^Fdf, Gd^Em, Gd, Ce, Ce, Ce, Rb, Gll^Em, Gd^Fdf, Gd^Fdf, Gd^Fdf, Gll
Mm, Mm, Hhd, Wwg, Ai, Mm, Mm, Ms, Hhd^Fmw, Aa^Fmw, Rb, Mm, Rb, Hhd, Aa, Hhd^Edb, Rb^Br|, Hhd^Edb, Hhd, Gd^Es, Gd^Es, Hhd, Hhd, Aa, Rb^Es, Gd, Wwrg, Wwrg, Wwg, Gd, Gll, Gll, Hhd, Hhd, Gd^Fdf, Gll, Chr^Ecf, Gd^Es, Gd^Gvs, Rb^Es, Rb, Gll, Gll, Gll^Em, Gll, Gll
Hhd, Mm, Mm, Ai, Hhd, Mm, Ms, Mm, Hhd^Fmw, Gd^Edb, Gd^Edb, Rb^Br|, Gll^Esa, Aa^Esa, Aa, Hhd, Rb, Gd^Es, Gd^Es, Gd^Fp, Mm, Mm, Hhd^Fp, Hhd^Fmf, Rb^Es, Rb^Es, Wwg, Wwg, Wwg, Ai, Gll, Gd^Fdf, Gd^Fdf, Hhd^Fmf, Hhd, Gll, Gd, Gd^Gvs, Gd^Gvs, Gd^Gvs, Gd, Gd^Vhr, Gd, Gd, Gd, Gd
Hhd, Mm, Hhd, Aa, Hhd^Es, Hhd, Mm, Mm, Hhd^Vhhr, Hhd^Edb, Hhd, Rb^Br|, Rb^Br\, Aa, Gll^Esa, Rb^Edb, Gll, Re^Dr, Hhd^Br\, Mm, Ms, Ms, Mm, Hhd^Fmf, Gd, Aa, Ai, Wwg, Wwg, Wwg, Gll, Gd^Fdf, Gll^Em, Hhd, Gll, Hhd, Gd^Gvs, Gd^Gvs, Gll, Gll, Gll^Es, Gd, Gd^Gvs, Gd^Gvs, Gd^Gvs, Gd
Hhd, Hhd, Gd^Fp, Aa, Aa^Esa, Hhd^Es, Hhd, Mm, Hhd, Hhd, Gd^Es, Gd^Es, Gll^Es, Re^Dr, Gll^Edb, Gll^Edb, Rb^Es, Gd^Edb, Hhd, Hhd^Vhhr, Ms, Mm, Hhd, Ai, Ai, Ai, Ai, Wwg, Wwg, Ww^Ewl, Gd^Es, Gll^Es, Gll, Gll, Gd^Fdf, Gll, Gll, Gd^Gvs, Hhd, Gd^Fdf, Gll^Es, Gd^Es, Gd, Gd^Gvs, Gd^Gvs, Gd
Hhd, Hhd, Hhd, Aa, Aa^Esa, Hhd, Gd^Es, Gd^Fp, Gd^Fmw, Hhd, Rb, Gd^Edb, Aa, Rb^Esa, Aa, Gd^Edb, Gd^Esa, Hhd, Gd^Fp, Hhd, Mm, Mm, Hhd, Aa, Gd, Gd, Sm, Wwg, Wwg, Wwrg, Gd, Gd^Es, Hhd, Gd^Fdf, Hhd, Gd^Fdf, Gll, Gd, Hhd, Hhd, Gd^Fdf, Gll, Gd, Gd, Gd, Gd
Hhd, Hhd, Hhd^Fmw, Gd^Esa, Aa, Aa^Esa, Gll^Es, Gll^Edb, Aa, Gd, Rb, Rb^Es, Aa, Aa^Esa, Gll^Esa, Aa, Gll^Es, Gd^Fmw, Gd^Fp, Hhd^Fp, Hhd, Hhd, Rb^Es, Gd, Gd, Chw, Wwrg, Wwg, Ai, Gd, Gll^Fdf, Gd^Es, Hhd^Fmf, Hhd, Hhd, Gll^Es, Gd, Gd, Gll^Fmf, Gd^Fmf, Gd^Fdf, Gll^Em, Gd, Gd^Vhr, Gd, Gd
Hhd, Gd^Fp, Gd^Fp, Gd, Gd^Esa, Aa, Rb^Esa, Aa, Aa^Esa, Aa, Gll^Es, Gll^Esa, Gd^Edb, Rb^Vhr, Rb, Gll^Fmw, Gd, Rb, Hhd, Hhd, Chr^Edt, Re^Edt, Re^Edt, Gd, Ai, Wwrg, Wog, Wwg, Wwrg, Gd, Hhd, Gd^Fdf, Gll^Em, Gd, Gd, Gd^Vhr, Gd^Gvs, Gd^Gvs, Gd, Gll^Em, Gll, Gll^Es, Gd^Gvs, Gd^Gvs, Gd^Gvs, Gd
Gd, Gd^Fp, Gll^Fp, Gll, Gll^Es, Gll^Es, Gll, Aa, Rb, Gll^Esa, Gd, Gd^Edb, Gd^Edb, Gd^Edb, Gd, Gd, Gd, Re, Co, Co, 1 Khr, Chr^Edt, Re^Edt, Ai^Edt, Wwg^Edt, Wwg^Edt, Wog, Wwg, Gd, Gll, Gd^Fdf, Gd^Fdf, Gll, Gd^Es, Gd, Gd^Gvs, Gd^Gvs, Gd^Gvs, Gd^Gvs, Gd, Gd, Gd, Gd^Gvs, Gd^Gvs, Gd^Gvs, Gd
Gd, Gll^Es, Gd, Gll, Gd^Es, Gll, Gd, Gll, Gd, Gd, Re^Edt, Co, Re^Vct, Gd, Re^Vct, Co, Re, Re, Co, Chr, Co, Chr^Edt, Re^Edt, Ai^Edt, Wwg^Edt, Wog^Edt, Wwg, Ai, Ai, Gll, Gll, Gll, Re, Re, Re, Gd^Gvs, Co, Gd, Re^Es, Re, Re, Gd, Gd, Gd, Gd, Gd
Rb, Gd, Rb, Gd, Rb, Gd, Rb, Gd, Rb, Re, Rb^Edt, Rb^Edt, Rb^Edt, Rb, Rb, Rb^Edt, Rb^Vct, Re^Edt, Rb^Edt, Co, Rb, Re, Wwg^Bp\, Wwg^Edt, Co, Co^Vct, Chr, Ai, Wwg^Bp/, Gd, Rb, Gd, Re, Co, Re, Re, Re^Vct, Re^Es, Re^Es, Co, Re^Es, Gd, Rb, Gd, Rb^Edt, Gd
Rb^Edt, Rb, Rb^Edt, Rb, Rb, Rb, Rb^Edt, Rb, Rb^Edt, Rb^Edt, Rb, Rb, Rb^Vct, Rb^Edt, Rb^Vct, Rb^Edt, Rb, Rb^Edt, Rb^Edt, Rb^Edt, Rb^Edt, Rb^Edt, Wwg^Bp\, Rb^Edt, Rb^Es, Rb^Edt, Rb^Es, Rb^Edt, Wwg^Bp/, Rb, Rb, Rb^Edt, Rb^Edt, Re^Edt, Rb^Edt, Rb, Rb, Rb^Es, Rb^Edt, Re^Edt, Rb^Edt, Rb, Rb, Rb^Edt, 2 Rb^Edt, Rb^Edt
Re, Rb^Edt, Re, Rb, Hhd, Rb^Edt, Re, Rb^Edt, Re, Rb, Re, Co, Re, Rb, Re, Co, Re, Rb, Re, Rb, Re, Rb, Wwg^Bp/, Rb, Chr, Rb^Edt, Co^Vct, Rb^Es, Wwg^Bp\, Rb, Gd, Rb, Re, Re, Re, Rb, Re^Vct, Rb, Re, Re, Re, Rb, Gll, Rb, Gd^Fdf, Rb
Hhd, Hhd, Hhd, Hhd, Mm, Hhd, Gd^Es, Gd^Es, Hhd, Gd, Gd, Re, Gd, Gd, Gd, Re, Gd, Gd, Gd, Gd, Gd, Re, Ai, Wwg, Wog, Chw, Ai, Ai, Gd, Gd, Gd^Gvs, Gd, Re, Co, Re^Es, Re^Es, Co, Re, Re, Co, Re, Gd, Gll, Gd^Fdf, Gd^Fdf, Gd^Fdf
Mm, Hhd, Mm, Hhd, Mm, Mm, Hhd, Hhd, Hhd, Hhd, Gd^Es, Gd, Gd, Gd^Edt, Gll, Gd, Gd, Gd^Gvs, Gd^Gvs, Gd^Gvs, Gd^Gvs, Gd, Gd, Wwg, Wog, Wwg, Gd, Ai, Gd^Gvs, Gd^Gvs, Gd, Rb, Gd^Gvs, Re, Gd^Es, Gd^Es, Gd^Gvs, Gd^Gvs, Gd, Re, Gd, Gll, Gd^Fdf, Gd^Fdf, Gd^Fdf, Gd^Fdf
Ms, Ms, Ms, Mm, Mm, Hhd, Hhd, Hhd, Gd, Hhd, Gd, Gd, Gll, Gll, Gll^Esa, Gll^Edt, Gll^Vhr, Gll^Gvs, Gd^Gvs, Gd^Gvs, Gd, Gd, Sm, Wog, Wwg, Aa, Gd, Gd, Gd^Gvs, Gd^Gvs, Gll, Gd^Gvs, Gd^Gvs, Gd, Gd^Es, Gd^Gvs, Gd^Gvs, Gd^Gvs, Gd^Gvs, Gd, Gd, Gll, Gll, Gll^Fmf, Gll, Gll
Ms, Ms, Mm, Mm, Hhd, Mm, Hhd, Gd^Es, Gd^Gvs, Gd^Edt, Gll^Edt, Gd, Gll^Esa, Aa, Aa, Gll^Edt, Gll^Edt, Gll^Gvs, Gd, Gd, Gd^Es, Chr, Wwg, Wwg, Ai, Wwrg, Gd^Gvs, Gd, Gll, Gll, Gd, Gd^Vhr, Gd, Gd, Gd, Gd^Gvs, Gd, Gd^Gvs, Gd, Gd, Gll, Gd, Gll, Gd, Gd, Gd
Mm, Mm, Hhd, Hhd, Hhd, Hhd, Gd^Fmf, Gd^Gvs, Gd^Gvs, Gll^Vhr, Gll^Gvs, Gll^Edt, Aa^Edb, Aa^Esa, Gll^Esa, Gll, Hhd, Gd^Es, Hhd^Fmf, Gd^Em, Gd^Fdf, Sm, Wwg, Wwg, Gd, Gd, Gd^Gvs, Gd, Gll, Gd, Gd, Gd, Gd^Gvs, Gd, Gd, Gd, Chr, Gd, Gll, Gd^Vhr, Gd^Fdf, Gll, Gd^Fdf, Gll, Gd, Gd
Hhd, Hhd, Aa, Hhd, Aa^Esa, Hhd, Gd^Esa, Gd, Aa^Edb, Gll^Edt, Gd^Fmf, Gll^Edb, Gll^Esa, Aa, Gll, Hhd, Hhd, Hhd, Hhd^Fmf, Gd^Fdf, Ww^Ewl, Wwg, Wwg, Ai, Ai, Gd^Gvs, Gd^Gvs, Gd, Gd, Gd, Gd, Gd^Gvs, Gd^Gvs, Gd, Gd, Gd^Es, Gd^Es, Gd, Gll, Gd^Fdf, Gd^Fmf, Gd^Fdf, Gll, Gll, Gd, Gd
Hhd, Hhd, Hhd, Aa, Aa^Esa, Aa, Aa^Edb, Gd^Edb, Aa^Edb, Aa^Edb, Gd^Edb, Gd^Fmf, Gd, Gll, Hhd, Hhd, Hhd^Fmf, Hhd^Fmf, Gd^Fdf, Gd^Fdf, Gd^Fdf, Wwg, Wwg, Wwg, Wwrg, Gd, Gll^Fmw, Gd, Gll, Gll^Fmw, Gd, Gd^Gvs, Gd^Gvs, Gd^Vhr, Gll^Edt, Gd^Es, Gd^Gvs, Gd, Gd^Gvs, Gll^Fmf, Gll, Gd^Fdf, Gll, Gd, Gd, Gd
Hhd, Hhd, Aa, Hhd, Gd^Fmf, Aa, Gll^Em, Gll^Esa, Gd, Gd^Edb, Gd^Edt, Gd^Edt, Gd, Hhd, Gd^Es, Hhd, Gll^Fdf, Hhd^Fmf, Gll^Feth, Gd^Fdf, Gd^Fdf, Ww^Ewl, Ai, Wwrg, Wwrg, Gll^Fmw, Gll^Fdw, Ss, Ss, Gll, Gd, Gd^Gvs, Gd, Gd, Chr, Gd, Gd^Gvs, Gd^Gvs, Gd^Gvs, Gd, Gd, Gll, Gd, Gd, Gll, Gll
Gd^Fmf, Gd^Fmf, Aa, Gd^Fmf, Gd^Esa, Gd^Fmf, Gd, Gd, Gd^Gvs, Gll^Gvs, Gll, Gd^Vhr, Gd^Edt, Gd, Gll, Gll^Fdf, Gll^Fdf, Gd^Fdf, Gd^Fdf, Gd^Fdf, Gd^Em, Ai, Wwg, Wwg, Ww^Ewl, Ss, Gs, Gs^Em, Ss, Gll^Fmw, Gd, Gd, Gll^Fmw, Gd, Gll^Es, Chr^Ecf, Rb^Edt, Gd^Gvs, Ch, Gd, Gd, Gd, Gd, Gll, Gd^Fdf, Gd^Fdf
Aa, Gll^Fmf, Aa^Esa, Aa^Esa, Aa, Aa, Gll^Edb, Gd^Gvs, Gll, Gll^Gvs, Hhd, Gd, Hhd, Gd, Hhd^Fmf, Gll^Em, Gd^Fdf, Gd^Fdf, Gd^Fdf, Gd^Fdf, Ai, Wwg, Wog, Wog, Ss, Ss, Gs^Es, Gs^Es, Ss, Ss^Vhs, Gs, Gd, Gll^Fdw, Gll^Fmw, Gd, Gll^Es, Rb^Es, Chr, 4 Kh, Chr, Gd, Gd, Gll, Gll^Fmf, Gd^Fdf, Gd^Fdf
Aa, Aa, Aa, Aa^Esa, Aa, Gll^Esa, Gll, Gll^Gvs, Gll, Gd^Es, Hhd, Hhd, Hhd^Fmf, Hhd^Fmf, Hhd^Fmf, Gd^Fdf, Gd^Fdf, Gd^Fdf, Gd^Fdf, Ai, Ai, Wwg, Wog, Ai, Ai, Ai, Ss, Gs^Es, Gs, Gs^Em, Gs, Gs^Em, Ss, Gll^Fmw, Gll^Fmw, Gd, Gll^Es, Rb^Es, Rb, Rb, Gd, Gd, Gll, Gd^Fdf, Gd^Fmf, Gd^Fdf
Aa, Aa, Gd, Gll, Gll, Gll, Gll, Gll, Hhd, Hhd, Hhd, Hhd, Hhd, Hhd^Fmf, Gd, Hh, Gll^Fdf, Gd^Fdf, Gll^Fdf, Ai, Wwg, Wog, Wog, Wog, Ai, Ai, Gd, Gd, Gd, Gs, Ss, Ss, Ss, Gd, Gd, Gd, Gll, Gd, Rb, Rb, Gd, Gd, Gd, Gll, Gd^Fdf, Gd^Fdf
