Mm, Mm, Mm, Mm, Mm, Mm, Mm, Mm, Mm, Mm, Mm, Mm, Mm, Mm, Mm, Mm, Mm, Mm, Hhd, Hhd, Hhd, Hhd, Gd, Gd, Gd, Gd, Ai, Ai, Wog, Wog, Wog, Ai, Gd^Fdf, Gd^Fdf, Gd^Fdf, Gd, Gll, Gd, Gd, Gd, Gd, Gd, Gll, Gd^Fdf, Gd^Fdf, Gd
Ms, Ms, Mm, Mm, Hhd, Mm, Hhd, Hhd, Hhd, Mm, Mm, Mm, Hhd, Mm, Hhd, Mm, Mm, Mm, Mm, Hhd, Gd^Es, Gd, Aa, Gll, Aa, Ai, Ai, Wwg, Wog, Wog, Ai, Ai, Ai, Gd^Fdf, Gd^Fdf, Gd^Fdf, Gd, Gd, 3 Gd, Gd, Gd, Gll, Gd^Fdf, Gd^Fdf, Gd^Fdf, Gd^Fdf
Ms, Mm, Hhd, Hhd, Hhd, Hhd, Ms, Ms, Aa, Aa, Mm, Mm, Mm, Hhd, Hhd, Hhd, Hhd^Vhhr, Mm, Hhd, Mm, Gd^Es, Aa, Hhd, Aa, Gll, Gd, Gd, Wwg, Wog, Wwg, Gd, Gll, Gd^Fdf, Gd^Fdf, Gd^Fdf, Gd, Gd, Gd, Gd, Gd^Gvs, Gd^Gvs, Gll, Gd^Fdf, Gd^Fdf, Gd^Fdf, Gll
Mm, Mm, Hhd, Hhd, Hhd, Mm, Mm, Ms, Hhd, Aa, Re, Mm, Re, Hhd, Aa, Hhd^Edb, Gd^Br|, Hhd^Edb, Hhd, Gd^Es, Gd^Es, Hhd, Hhd, Aa, Gd, Gd, Wwg, Wwg, Wwg, Gd, Gll, Gll, Hhd, Hhd, Gd^Fdf, Gll, Gd, Gd, Gd^Gvs, Gd^Gvs, Gd, Gll, Gll, Gll, Gll, Gll
Hhd, Mm, Mm, Hhd, Hhd, Mm, Ms, Mm, Hhd, Gd^Edb, Gd^Edb, Re^Br|, Gll, Aa, Aa, Hhd, Re, Gd^Es, Gd^Es, Gd^Fp, Mm, Mm, Hhd^Fp, Hhd^Fmf, Gd, Gd^Es, Wwg, Wwg, Wwg, Ai, Gll, Gd^Fdf, Gd^Fdf, Hhd^Fmf, Hhd, Gll, Gd, Gd^Gvs, Gd^Gvs, Gd^Gvs, Gd, Gd, Gd, Gd, Gd, Gd
Hhd, Mm, Hhd, Aa, Hhd, Hhd, Mm, Mm, Hhd^Vhhr, Hhd^Edb, Hhd, Re^Br|, Re^Br\, Aa, Gll^Esa, Re^Edb, Gll, Re^Dr, Hhd^Br\, Mm, Ms, Ms, Mm, Hhd^Fmf, Gd, Aa, Ai, Wwg, Wwg, Wwg, Gll, Gd^Fdf, Gll, Hhd, Gll, Hhd, Gd^Gvs, Gd^Gvs, Gll, Gll, Gll, Gd, Gd^Gvs, Gd^Gvs, Gd^Gvs, Gd
Hhd, Hhd, Gd^Fp, Aa, Aa, Hhd, Hhd, Mm, Hhd, Hhd, Gd^Es, Gd^Es, Gll^Es, Re^Dr, Gll, Gll^Edb, Gd^Es, Gd^Edb, Hhd, Hhd^Vhhr, Ms, Mm, Hhd, Hhd, Gd, Gd, Ai, Wwg, Wwg, Wwg, Gd, Gll, Gll, Gll, Gd^Fdf, Gll, Gll, Gd^Gvs, Hhd, Gd^Fdf, Gll, Gd, Gd, Gd^Gvs, Gd^Gvs, Gd
Hhd, Hhd, Hhd, Aa, Aa, Hhd, Gd^Es, Gd^Fp, Gd, Hhd, Gd, Gd^Edb, Aa, Gll, Aa, Gd, Gd, Hhd, Gd^Fp, Hhd, Mm, Mm, Hhd, Aa, Gd, Gd, Sm, Wwg, Wwg, Gd, Gd, Gd, Hhd, Gd^Fdf, Hhd, Gd^Fdf, Gll, Gd, Hhd, Hhd, Gd^Fdf, Gll, Gd, Gd, Gd, Gd
Hhd, Hhd, Hhd, Gd^Esa, Aa, Aa, Gll^Es, Gll^Edb, Aa, Gd, Gll, Gll^Es, Aa, Aa, Gll^Esa, Aa, Gll^Es, Gd, Gd^Fp, Hhd^Fp, Hhd, Hhd, Gd^Es, Gd, Gd, Chw, Wwg, Wwg, Ai, Gd, Gll^Fdf, Gd, Hhd^Fmf, Hhd, Hhd, Gll, Gd, Gd, Gll^Fmf, Gd^Fmf, Gd^Fdf, Gll, Gd, Gd, Gd, Gd
Hhd, Gd^Fp, Gd^Fp, Gd, Gd, Aa, Gll^Esa, Aa, Aa, Aa, Gll^Es, Gll, Gd, Gll^Vhr, Gd, Gll^Es, Gd, Gd, Hhd, Hhd, Chr, Re^Es, Re, Gd, Ai, Wwg, Wog, Wwg, Gd, Gd, Hhd, Gd^Fdf, Gll, Gd, Gd, Gd^Vhr, Gd^Gvs, Gd^Gvs, Gd, Gll, Gll, Gll, Gd^Gvs, Gd^Gvs, Gd^Gvs, Gd
Gd, Gd^Fp, Gll^Fp, Gll, Gll^Es, Gll^Es, Gll, Aa, Gll, Gll, Gd, Gd, Gd, Gd, Gd, Gd, Gd, Re, Co, Co, 1 Khr, Chr, Re, Ai, Wwg, Wwg, Wog, Wwg, Gd, Gll, Gd^Fdf, Gd^Fdf, Gll, Gd, Gd, Gd^Gvs, Gd^Gvs, Gd^Gvs, Gd^Gvs, Gd, Gd, Gd, Gd^Gvs, Gd^Gvs, Gd^Gvs, Gd
Gd, Gll^Es, Gd, Gll, Gd^Es, Gll, Gd, Gll, Gd, Gd, Re^Edt, Co, Re^Vct, Gd, Re^Vct, Co, Re, Re, Co, Chr, Co, Chr, Re, Ai, Wwg, Wog, Wwg, Ai, Ai, Gll, Gll, Gll, Re, Re, Re, Gd^Gvs, Co, Gd, Re, Re, Re, Gd, Gd, Gd, Gd, Gd
Rb, Gd, Rb, Gd, Rb, Gd, Rb, Gd, Rb, Re, Rb^Edt, Rb^Edt, Rb, Rb, Rb, Rb^Edt, Rb^Vct, Re, Rb, Co, Rb, Re, Wwg^Bp\, Wwg, Co, Co^Vct, Chr, Ai, Wwg^Bp/, Gd, Rb, Gd, Re, Co, Re, Re^Vct, Rb, Re, Re, Co, Re, Gd, Rb, Gd, Rb^Edt, Gd
Rb^Edt, Rb, Rb^Edt, Rb, Rb, Rb, Rb^Edt, Rb, Rb^Edt, Rb, Rb, Rb, Rb^Vct, Rb, Rb^Vct, Rb^Edt, Rb, Rb, Rb, Rb^Edt, Rb^Edt, Rb^Edt, Wwg^Bp\, Rb^Edt, Rb^Es, Rb^Edt, Rb^Es, Rb^Edt, Wwg^Bp/, Rb, Rb, Rb^Edt, Rb^Edt, Re^Edt, Rb^Edt, Rb, Rb, Rb, Rb^Edt, Re^Edt, Rb^Edt, Rb, Rb, Rb^Edt, 2 Rb^Edt, Rb^Edt
Re, Rb^Edt, Re, Rb, Hhd, Rb^Edt, Re, Rb^Edt, Re, Rb, Re, Co, Re, Rb, Re, Co, Re, Rb, Re, Rb, Re, Rb, Wwg^Bp/, Rb, Chr, Rb^Edt, Co^Vct, Rb^Es, Wwg^Bp\, Rb, Gd, Rb, Re, Re, Re, Rb, Rb, Rb^Vct, Re, Re, Re, Rb, Gll, Rb, Gd^Fdf, Rb
Hhd, Hhd, Hhd, Hhd, Mm, Hhd, Gd^Es, Gd^Es, Hhd, Gd, Gd, Re, Gd, Gd, Gd, Re, Gd, Gd, Gd, Gd, Gd, Re, Ai, Wwg, Wog, Chr, Ai, Ai, Gd, Gd, Gd^Gvs, Gd, Re, Co, Re, Re, Co, Re, Re, Co, Re, Gd, Gll, Gd^Fdf, Gd^Fdf, Gd^Fdf
Mm, Hhd, Mm, Hhd, Mm, Mm, Hhd, Hhd, Hhd, Hhd, Gd^Es, Gd, Gd, Gd^Edt, Gll, Gd, Gd, Gd^Gvs, Gd^Gvs, Gd^Gvs, Gd^Gvs, Gd, Gd, Wwg, Wog, Wwg, Gd, Ai, Gd^Gvs, Gd^Gvs, Gd, Rb, Gd^Gvs, Re, Gd, Gd, Gd^Gvs, Gd^Gvs, Gd, Re, Gd, Gll, Gd^Fdf, Gd^Fdf, Gd^Fdf, Gd^Fdf
Ms, Ms, Ms, Mm, Mm, Hhd, Hhd, Hhd, Gd, Hhd, Gd, Gd, Gll, Gll, Gll^Esa, Gll^Edt, Gll^Vhr, Gll^Gvs, Gd^Gvs, Gd^Gvs, Gd, Gd, Sm, Wog, Wwg, Aa, Gd, Gd, Gd^Gvs, Gd^Gvs, Gll, Gd^Gvs, Gd^Gvs, Gd, Gd, Gd^Gvs, Gd^Gvs, Gd^Gvs, Gd^Gvs, Gd, Gd, Gll, Gll, Gll^Fmf, Gll, Gll
Ms, Ms, Mm, Mm, Hhd, Mm, Hhd, Gd^Es, Gd^Gvs, Gd^Edt, Gll^Edt, Gd, Gll^Esa, Aa, Aa, Gll^Edt, Gll^Edt, Gll^Gvs, Gd, Gd, Gd^Es, Chr, Wwg, Wwg, Ai, Gd, Gd^Gvs, Gd, Gll, Gll, Gd, Gd^Gvs, Gd, Gd, Gd, Gd^Gvs, Gd, Gd^Gvs, Gd, Gd, Gll, Gd, Gll, Gd, Gd, Gd
Mm, Mm, Hhd, Hhd, Hhd, Hhd, Gd^Fmf, Gd^Gvs, Gd^Gvs, Gll^Vhr, Gll^Gvs, Gll^Edt, Aa, Aa, Gll^Esa, Gll, Hhd, Gd^Es, Hhd^Fmf, Gd, Gd^Fdf, Sm, Wwg, Wwg, Gd, Gd, Gd^Gvs, Gd, Gll, Gd, Gd, Gd, Gd^Gvs, Gd, Gd, Gd, Gd, Gd, Gll, Gd^Vhr, Gd^Fdf, Gll, Gd^Fdf, Gll, Gd, Gd
Hhd, Hhd, Aa, Hhd, Aa, Hhd, Gd^Esa, Gd, Aa, Gll^Edt, Gd^Fmf, Gll, Gll^Esa, Aa, Gll, Hhd, Hhd, Hhd, Hhd^Fmf, Gd^Fdf, Gd^Fdf, Wwg, Wwg, Ai, Ai, Gd^Gvs, Gd^Gvs, Gd, Gd, Gd, Gd, Gd^Gvs, Gd^Gvs, Gd, Gd, Gd, Gd, Gd, Gll, Gd^Fdf, Gd^Fmf, Gd^Fdf, Gll, Gll, Gd, Gd
Hhd, Hhd, Hhd, Aa, Aa, Aa, Aa, Gd, Aa, Aa, Gd, Gd^Fmf, Gd, Gll, Hhd, Hhd, Hhd^Fmf, Hhd^Fmf, Gd^Fdf, Gd^Fdf, Gd^Fdf, Wwg, Wwg, Wwg, Wwg, Gd, Gll^Fmw, Gd, Gll, Gll^Fmw, Gd, Gd^Gvs, Gd^Gvs, Gd^Vhr, Gll, Gd, Gd^Gvs, Gd, Gd^Gvs, Gll^Fmf, Gll, Gd^Fdf, Gll, Gd, Gd, Gd
Hhd, Hhd, Aa, Hhd, Gd^Fmf, Aa, Gll, Gll^Esa, Gd, Gd, Gd^Edt, Gd^Edt, Gd, Hhd, Gd^Es, Hhd, Gll^Fdf, Hhd^Fmf, Gll^Feth, Gd^Fdf, Gd^Fdf, Gd, Ai, Wwg, Wwg, Gll^Fmw, Gll^Fdw, Ss, Ss, Gll, Gd, Gd^Gvs, Gd, Gd, Gll, Gd, Gd^Gvs, Gd^Gvs, Gd^Gvs, Gd, Gd, Gll, Gd, Gd, Gll, Gll
Gd^Fmf, Gd^Fmf, Aa, Gd^Fmf, Gd^Esa, Gd^Fmf, Gd, Gd, Gd^Gvs, Gll^Gvs, Gll, Gd^Vhr, Gd^Edt, Gd, Gll, Gll^Fdf, Gll^Fdf, Gd^Fdf, Gd^Fdf, Gd^Fdf, Gd, Ai, Wwg, Wwg, Wwg, Ss, Gs, Gs^Em, Ss, Gll^Fmw, Gd, Gd, Gll^Fmw, Gd, Gll, Gd, Gd, Gd^Gvs, Gd, Gd, Gd, Gd, Gd, Gll, Gd^Fdf, Gd^Fdf
Aa, Gll^Fmf, Aa, Aa, Aa, Aa, Gll, Gd^Gvs, Gll, Gll^Gvs, Hhd, Gd, Hhd, Gd, Hhd^Fmf, Gll, Gd^Fdf, Gd^Fdf, Gd^Fdf, Gd^Fdf, Ai, Wwg, Wog, Wog, Ss, Ss, Gs, Gs, Ss, Ss, Gs, Gd, Gll^Fdw, Gll^Fmw, Gd, Gll, Gd, Gd, Gd, Gd, Gd, Gd, Gll, Gll^Fmf, Gd^Fdf, Gd^Fdf
Aa, Aa, Aa, Aa, Aa, Gll^Esa, Gll, Gll^Gvs, Gll, Gd^Es, Hhd, Hhd, Hhd^Fmf, Hhd^Fmf, Hhd^Fmf, Gd^Fdf, Gd^Fdf, Gd^Fdf, Gd^Fdf, Ai, Ai, Wwg, Wog, Ai, Ai, Ai, Ss, Gs, Gs, Gs^Em, Gs, Gs, Ss, Gll^Fmw, Gll^Fmw, Gd, Gll, Gd, Gd, Gd, Gd, Gd, Gll, Gd^Fdf, Gd^Fmf, Gd^Fdf
Aa, Aa, Gd, Gll, Gll, Gll, Gll, Gll, Hhd, Hhd, Hhd, Hhd, Hhd, Hhd^Fmf, Gd, Hh, Gll^Fdf, Gd^Fdf, Gll^Fdf, Ai, Wwg, Wog, Wog, Wog, Ai, Ai, Gd, Gd, Gd, Gs, Ss, Ss, Ss, Gd, Gd, Gd, Gll, Gd, Gd, Gd, Gd, Gd, Gd, Gll, Gd^Fdf, Gd^Fdf
