Ms^Xm, Ms^Xm, Ha, Ha, Ha, Hhd, Aa^Fma, Hhd, Hhd, Re, Hhd, Hhd, Ha, Ms, Ms, Ms, Ms^Xm, Ms^Xm, Ms, Ms, Ha, Ha, Hhd, Hhd, Aa, Re, Hhd, Hhd, Hhd, Ha, Ms, Hhd, Ms, Ms, Ms^Xm, Ms, Ms^Xm, Ms, Ms, Ha, Aa, Aa^Fma, Hhd, Hhd, Hhd, Hhd
Ms^Xm, Ms^Xm, Ms, Ha, Ms, Ha, Aa^Fma, Aa^Fma, Hhd, Re, Re, Aa, Ha, Ms, Ms, Ms, Ms^Xm, Ms^Xm, Ms, Ms, Ha, Ha, Hhd, Hhd, Re, Re, Aa^Fma, Hhd^Fdw, Ha, Ha, Ms, Ms, Ms, Ms, Ms^Xm, Ms^Xm, Ms, Ms, Ms, Ha, Aa, Aa^Fma, Aa^Fma, Hhd^Fdw, Hhd^Fdw, Hhd
Ms^Xm, Ms^Xm, Ms^Xm, Ms, Ms, Ms, Aa^Fma, Aa, Hhd^Fdw, Hhd, Re, Hhd, Hhd^Vo, Ha, Ms, Ha, Ms, Ms, Ms, Ha, Aa^Fma, Hhd, Aa, Hhd^Esa, Re, Hhd^Fdw, Aa, Aa^Fma, Ha, Ms, Ms, Ms, Ms, Ms, Ms^Xm, Ms^Xm, Ms, Ha, Ms, Ha, Hhd^Fdw, Aa^Fma, Aa^Fdw, Hhd^Fdw, Hhd, Hhd
Ms, Ms^Xm, Ms^Xm, Ms^Xm, Ms^Xm, Ms, Ha, Aa, Hhd^Fdw, Hhd, Hhd^Esa, Re, Aa, Aa, Ha, Ms, Ms, Ms, Ms, Ha, Ha, Hhd, Aa, Aa, Re, Hhd^Fdw, Hhd^Fdw, Ha, Ha, Ha, Ms, Ms, Ms, Ms^Xm, Ms^Xm, Ms, Ms, Ms, Ha, Aa^Fma, Aa^Fma, Hhd^Fdw, Hhd^Fdw, Hhd^Fdw, Ha, Ha
Ms^Xm, Ms^Xm, Ms^Xm, Ms^Xm, Ms, Ms, Ha, Ha, Ha, Hhd^Fdw, Hhd, Re, Re, Aa, Hhd^Fdw, Ha, Ms, Ms, Ha, Ms, Ha, Hhd, Hhd, Re, Aa, Hhd, Hhd, Ha, Ms, Ms, Ms, Ms, Ms, Ms, Ms^Xm, Ms, Ms, Ms, Aa^Fma, Aa^Fma, Aa^Fma, Ha, Ha, Ha, Ms, Ha
Ms, Ms, Ms, Ms^Xm, Ms, Ms, Ms, Ms, Ha, Aa^Fma, Aa^Fma, Hhd, Re, Hhd, Hhd^Fdw, Ha, Ha, Ha, Hhd, Ha, Hhd^Esa, Hhd, Co^Ecf, Re, Co^Ecf, Hhd, Aa, Ha, Ms, Ms, Ms, Ms, Ms, Ms, Ms, Ms, Ms, Aa^Fma, Aa, Aa, Ha, Ha, Ms, Ms, Ms^Xm, Ms
Ms, Ms^Xm, Ms, Ms^Xm, Ms^Xm, Ms, Ms, Ms, Ha, Aa^Fma, Aa, Hhd^Fdw, Hhd, Re, Hhd^Esa, Hhd^Fdw, Hhd, Hhd, Ai, Hhd^Esa, Rb^Esa, Rb^Edt, Re, Re, Re, Rb, Sm^Edt, Ai, Ms, Ms, Ha, Ms, Ha, Ms, Ms, Ms, Ha, Ha, Aa, Aa, Ha, Ms, Ms, Ms, Ms^Xm, Ms^Xm
Ms, Ms, Ms, Ms, Ms^Xm, Ms^Xm, Ms, Ha, Aa, Aa, Aa, Hhd^Esa, Hhd, Re, Hhd, Hhd, Hhd, Hhd, Sm^Edt, Sm^Ewl, Co^Vo, Aa, Re, Re, Re^Es, Gll, Co^Vo, Rb^Edt, Rb^Esa, Ha, Hhd, Ha, Ha, Ms, Ha, Ms, Ha, Aa, Ha, Ha, Ms, Ms, Ms, Ms^Xm, Ms, Ha
Ha, Ms, Ms, Ms, Ms, Ms^Xm, Ms^Xm, Ms, Ms, Ha, Ha, Aa^Fma, Hhd, Re, Re, Re, Re, Co^Ecf, Re, Sm^Edt, Gll^Edt, Gll^Fdw, Re, Re, Re, Aa, Gll, Gll^Fdw, Re, Co, Hhd, Hhd^Esa, Hhd, Ha, Hhd^Fdw, Ha, Aa, Ha, Ms, Ms, Ms, Ms, Ms, Ms, Ms, Ha
Aa^Fma, Ha, Ha, Ms, Ms, Ms^Xm, Ms^Xm, Ms, Ms, Ha, Ms, Ha, Ha, Hhd, Hhd, Hhd, Co^Ecf, Re, Re^Vo, Re^Edt, Re^Edt, Rb, Re, Re^Vo, Re^Edt, Rb, Re^Es, Re, Re^Vo, Re, Co^Ecf, Hhd, Hhd, Hhd^Fdw, Hhd^Fdw, Aa^Fma, Aa, Ha, Ms, Ms, Ms, Ms, Ms, Ms, Ha, Ha
Aa^Fma, Aa^Fma, Ha, Ms, Ai, Ms, Ms, Ms, Ms, Ms, Ms, Ms, Ha, Hhd, Hhd, Aa, Rb^Es, Re, Re, Re, Re^Vo, Re, Rd, Re, Rd^Edt, Re^Edt, 2 Ko, Re, Sm^Edt, Re^Es, Gll, Hhd, Hhd, Hhd^Fdw, Aa, Aa^Fma, Aa^Fma, Ha, Ha, Ms, Ha, Ha, Ha, Ha, Aa, Hhd
Aa^Fma, Aa, Aa^Fma, Ha, Ai, Ms, Ms, Ms, Ha, Ha, Ha, Ha, Hhd^Esa, Hhd^Esa, Hhd, Hhd, Gll^Fdw, Gll^Es, Aa, Re, Re, Re, Rd, Rd, Rd, Re, Re^Edt, Re, Gll^Es, Gll^Fdw, Gll^Fdw, Co, Hhd, Hhd, Hhd, Aa, Hhd, Hhd, Hhd, Hhd^Fdw, Hhd, Aa, Aa, Mm, Aa, Hhd
Aa^Fma, Aa^Fma, Aa^Fma, Aa^Fma, Ai, Ha, Ha, Ha, Hhd, Aa, Hhd, Hhd^Esa, Ai, Hhd, Hhd, Hhd, Ai, Sm^Edt, Sm^Edt, Re^Edt, Re^Vo, Rd, Rd, Rd, Rd, Rd, Rd^Edt, Rd^Edt, Re, Gll^Fdw, Gll^Es, Rb^Edt, Hhd, Hhd, Hhd, Hhd, Re, Re, Re, Re, Re, Hhd^Fdw, Hhd, Hhd, Hhd, Hhd
Aa^Fma, Aa^Fma, Aa, Aa^Fma, Aa^Fma, Ai, Ai, Ai, Wwf, Hhd, Wwg, Ai, Wwg, Hhd, Hhd, Hhd, Co, Sm^Ewl, Re^Vo, Re, Re^Edt, 1 Re, Rd, Rd, Rd, Rd, Rd, Re, Re^Vo, Aa, Re^Edt, Rb, Rb, Hhd, Hhd, Hhd, Re, Hhd, Hhd, Hhd, Hhd, Re, Re, Aa, Re, Re
Ha^Fdw, Aa^Fma, Aa, Aa, Ha, Aa^Fma, Aa^Fma, Hhd, Hhd, Wwf, Wog, Wwg, Wwg, Hhd, Re, Hhd, Re, Re, Re, Re^Edt, Gll^Fdw, Gll, Re, Re, Re, Rd, Re, Re, Re, Re, Re^Vo, Re, Co^Ecf, Hhd, Hhd, Re, Hhd, Hhd, Gll^Esa, Hhd, Hhd, Gll^Vo, Gll^Esa, Re, Gll^Esa, Gll
Ha, Ha^Fdw, Ms, Ha, Ms, Ha, Ai, Hhd, Ai, Hhd, Wog, Wog, Wwg, Re, Re, Re, Hhd, Co^Ecf, Rb, Rb, Re^Es, Re^Edt, Re^Edt, Re^Vo, Re, Re, Re^Vo, Re^Edt, Rb^Edt, Sm^Ewl, Re, Re, Re, Hhd, Re, Re, Hhd, Hhd, Hhd, Hhd, Aa, Aa, Hhd, Aa, Aa, Hhd
Ha, Ha^Fdw, Ms, Ms^Xm, Ms, Ai, Ha, Ai, Hhd, Wwf, Wwg, Wog, Wwg, Re, Re, Re, Hhd, Hhd, Aa, Co^Ecf, Re, Re^Edt, Aa, Re, Gll, Re^Edt, Re, Re^Edt, Co^Vo, Rb, Rb, Co^Ecf, Hhd, Re, Gll, Hhd, Hhd, Hhd, Gll^Esa, Hhd, Hhd^Fdw, Aa, Aa^Fma, Hhd, Aa^Fma, Hhd
Ha, Ha, Ha, Ms, Ha, Ms, Ha, Hhd, Hhd, Hhd, Wwg, Wwg, Ai, Wwg, Wwg, Hhd^Vo, Hhd, Hhd, Hhd, Hhd, Co, Re, Rb, Co^Vo, Gll^Es, Aa, Re, Re, Gll^Es, Sm^Ewl, Ai, Hhd, Hhd, Hhd, Aa, Gll, Hhd, Hhd, Aa, Hhd, Ha, Aa^Fma, Ha, Ha, Ha, Ha
Ha, Ha, Aa^Fma, Ha, Ha, Ms, Ha, Hhd, Ai, Wwg, Hhd, Hhd, Hhd, Ai, Hhd, Ai, Ai, Aa, Hhd, Hhd, Hhd, Rb^Es, Sm^Edt, Sm^Edt, Rb, Re, Re, Re, Rb^Edt, Gll^Fdw, Hhd, Hhd, Hhd, Hhd, Hhd, Gll, Gll^Esa, Aa, Aa^Fma, Aa^Fma, Ha, Ha, Ms, Ha, Ha, Ms
Ha, Aa^Fma, Aa^Fma, Aa, Aa^Fma, Ha, Hhd, Hhd, Ai, Hhd, Ha, Ha, Ha, Hhd^Fdw, Ha, Hhd, Ai, Hhd, Ha, Hhd, Hhd, Hhd, Hhd, Ai, Hhd, Co^Ecf, Re, Co^Ecf, Hhd, Hhd, Hhd, Hhd, Hhd, Hhd, Hhd, Hhd, Gll^Esa, Aa, Hhd, Aa^Fma, Ha, Ms, Ms, Ms, Ms, Ha
Ms, Ha, Ha, Aa, Aa, Aa^Fma, Hhd^Fdw, Ai, Hhd, Hhd^Fdw, Ha, Ms, Ha, Ms, Ms^Xm, Ha, Ms, Hhd, Ms, Ha, Ha, Aa, Hhd^Fdw, Hhd, Hhd, Hhd, Re, Hhd, Hhd, Hhd, Hhd, Hhd, Hhd, Hhd, Gll, Hhd, Hhd, Hhd, Hhd, Ha, Ms, Ms, Ha, Ha, Ha, Ha
Ms, Ms, Ms, Ha, Ha, Aa^Fma, Hhd^Fdw, Wwg, Ai, Hhd, Ai, Ha, Ms, Ms, Ms, Ms^Xm, Ms^Xm, Ms, Ha, Ha, Aa^Fma, Hhd^Fdw, Aa, Hhd, Hhd, Hhd, Gll, Re, Hhd, Hhd, Hhd, Hhd^Vo, Hhd, Hhd, Gll, Gll^Esa, Aa, Hhd, Aa^Fma, Ha, Ha, Ha, Aa^Fma, Aa, Aa^Fma, Ha
Ms, Ms, Ms, Ms, Ha, Hhd^Fdw, Hhd, Hhd, Wwg, Ai, Wwg, Hhd^Fdw, Hhd^Fdw, Ha, Ha, Ms, Ha, Ms, Ha, Ha, Aa, Hhd^Fdw, Aa, Aa, Gll^Esa, Gll, Gll, Re, Re, Hhd, Hhd, Hhd, Hhd, Hhd, Hhd, Aa, Aa, Aa, Hhd, Hhd, Hhd^Fdw, Hhd^Fdw, Hhd^Fdw, Aa^Fma, Hhd^Fdw, Hhd
Ha, Ha, Ha, Ms, Ha, Ha, Hhd^Fdw, Hhd, Hhd, Wwg, Ai, Wwg, Ai, Hhd, Hhd, Ha, Hhd^Fdw, Ha, Aa^Fma, Aa^Fma, Aa, Aa, Aa, Aa, Aa, Gll^Esa, Gll, Gll, Gll, Re, Hhd, Hhd, Hhd, Gll, Hhd, Gll^Esa, Hhd, Hhd, Hhd, Hhd, Hhd, Aa, Aa, Aa, Aa, Hhd
Hhd, Hhd, Hhd, Ha, Hhd, Hhd, Hhd, Hhd, Hhd, Hhd, Hhd, Wwg, Hhd, Hhd, Hhd, Hhd, Hhd, Aa^Fma, Aa^Fma, Aa, Aa, Aa, Aa, Aa, Aa, Aa, Gll, Gll, Gll, Re, Gll, Hhd, Hhd, Hhd, Hhd, Hhd, Hhd, Aa, Hhd, Hhd, Gll, Aa, Aa, Aa, Aa, Hhd
