Ms^Xm, Ms^Xm, Ms^Xm, Ms^Xm, Ms^Xm, Ms^Xm, Ms^Xm, Ms^Xm, Ms^Xm, Ms^Xm, Ms^Xm, Ms^Xm, Ms^Xm, Ms^Xm, Ms^Xm, Ms^Xm, Ms^Xm, Ms^Xm, Ms^Xm, Ms^Xm, Ms^Xm, Ms^Xm, Ms^Xm, Ms^Xm, Ms^Xm, Ms^Xm, Ms^Xm, Ms^Xm, Ms^Xm, Ms^Xm, Ms^Xm, Ms^Xm, Ms^Xm, Ms^Xm, Ms^Xm, Ms^Xm, Ms^Xm, Ms^Xm, Ms^Xm, Ms^Xm, Ms^Xm, Ms^Xm, Ms^Xm, Ms^Xm, Ms^Xm, Ms^Xm
Ms^Xm, Ms^Xm, Ms^Xm, Ms^Xm, Ms^Xm, Ms^Xm, Ms^Xm, Ms^Xm, Ms^Xm, Ms^Xm, Ms^Xm, Ms^Xm, Ms^Xm, Ms^Xm, Ms^Xm, Ms^Xm, Ms^Xm, Ms^Xm, Ms^Xm, Ms^Xm, Ms^Xm, Ms^Xm, Ms^Xm, Ms^Xm, Ms^Xm, Ms^Xm, Ms^Xm, Ms^Xm, Ms^Xm, Ms^Xm, Ms^Xm, Ms^Xm, Ms^Xm, Ms^Xm, Ms^Xm, Ms^Xm, Ms^Xm, Ms^Xm, Ms^Xm, Ms^Xm, Ms^Xm, Ms^Xm, Ms^Xm, Ms^Xm, Ms^Xm, Ms^Xm
Ms^Xm, Ms^Xm, Ms^Xm, Ms^Xm, Ms^Xm, Ms^Xm, Ms^Xm, Ms^Xm, Ms^Xm, Ms^Xm, Ms^Xm, Ms^Xm, Ms^Xm, Ms^Xm, Ms^Xm, Ms^Xm, Ms^Xm, Ms^Xm, Ms^Xm, Ms^Xm, Ms^Xm, Ms^Xm, Ms^Xm, Ms^Xm, Ms^Xm, Ms^Xm, Ms^Xm, Ms^Xm, Ms^Xm, Ms^Xm, Ms^Xm, Ms^Xm, Ms^Xm, Ms^Xm, Ms^Xm, Ms^Xm, Ms^Xm, Ms^Xm, Ms^Xm, Ms^Xm, Ms^Xm, Ms^Xm, Ms^Xm, Ms^Xm, Ms^Xm, Ms^Xm
Ms^Xm, Ms^Xm, Ms^Xm, Ms^Xm, Ms^Xm, Ms^Xm, Ms^Xm, Ms^Xm, Ms^Xm, Ms^Xm, Ms^Xm, Ms^Xm, Ms^Xm, Ms^Xm, Ms^Xm, Ms^Xm, Ms^Xm, Ms^Xm, Ms^Xm, Ms^Xm, Ms^Xm, Ms^Xm, Ms^Xm, Ms^Xm, Ms^Xm, Ms^Xm, Ms^Xm, Ms^Xm, Ms^Xm, Ms^Xm, Ms^Xm, Ms^Xm, Ms^Xm, Ms^Xm, Ms^Xm, Ms^Xm, Ms^Xm, Ms^Xm, Ms^Xm, Ms^Xm, Ms^Xm, Ms^Xm, Ms^Xm, Ms^Xm, Ms^Xm, Ms^Xm
Ms^Xm, Ms^Xm, Ms^Xm, Ms^Xm, Ms^Xm, Ms^Xm, Ms^Xm, Ms^Xm, Ms^Xm, Ms^Xm, Ms^Xm, Ms^Xm, Ms^Xm, Ms^Xm, Ms^Xm, Ms^Xm, Ms^Xm, Ms^Xm, Ms^Xm, Ms^Xm, Ms^Xm, Ms^Xm, Xue, Ms^Xm, Ms^Xm, Ms^Xm, Ms^Xm, Ms^Xm, Ms^Xm, Ms^Xm, Ms^Xm, Ms^Xm, Ms^Xm, Ms^Xm, Ms^Xm, Ms^Xm, Ms^Xm, Ms^Xm, Ms^Xm, Ms^Xm, Ms^Xm, Ms^Xm, Ms^Xm, Ms^Xm, Ms^Xm, Ms^Xm
Ms^Xm, Ms^Xm, Ms^Xm, Ms^Xm, Ms^Xm, Ms^Xm, Ms^Xm, Ms^Xm, Ms^Xm, Ms^Xm, Ms^Xm, Ms^Xm, Ms^Xm, Ms^Xm, Ms^Xm, Ms^Xm, Ms^Xm, Ms^Xm, Xue, Xue, Xue, Xue, Xue, Xue, Xue, Xue, Xue, Ms^Xm, Ms^Xm, Ms^Xm, Ms^Xm, Ms^Xm, Ms^Xm, Ms^Xm, Ms^Xm, Ms^Xm, Ms^Xm, Ms^Xm, Ms^Xm, Ms^Xm, Ms^Xm, Ms^Xm, Ms^Xm, Ms^Xm, Ms^Xm, Ms^Xm
Ms^Xm, Ms^Xm, Ms^Xm, Ms^Xm, Ms^Xm, Ms^Xm, Ms^Xm, Ms^Xm, Ms^Xm, Ms^Xm, Ms^Xm, Ms^Xm, Ms^Xm, Ms^Xm, Ms^Xm, Ms^Xm, Xue, Xue, Xue, Xue, Xue, Xue, Uue^Feth, Xue, Xue, Xue, Xue, Xue, Xue, Ms^Xm, Ms^Xm, Ms^Xm, Ms^Xm, Ms^Xm, Ms^Xm, Ms^Xm, Ms^Xm, Ms^Xm, Ms^Xm, Ms^Xm, Ms^Xm, Ms^Xm, Ms^Xm, Ms^Xm, Ms^Xm, Ms^Xm
Ms^Xm, Ms^Xm, Ms^Xm, Ms^Xm, Ms^Xm, Ms^Xm, Ms^Xm, Ms^Xm, Ms^Xm, Ms^Xm, Ms^Xm, Ms^Xm, Ms^Xm, Ms^Xm, Ms^Xm, Ms^Xm, Xue, Xue, Ur^Edb, Uue^Edb, Rb^Edb, Uue, Uhe, Uue, Re^Edb, Uue, Ur, Xue, Xue, Ms^Xm, Ms^Xm, Ms^Xm, Ms^Xm, Ms^Xm, Ms^Xm, Ms^Xm, Ms^Xm, Ms^Xm, Ms^Xm, Ms^Xm, Ms^Xm, Ms^Xm, Ms^Xm, Ms^Xm, Ms^Xm, Ms^Xm
Ms^Xm, Ms^Xm, Ms^Xm, Ms^Xm, Ms^Xm, Ms^Xm, Ms^Xm, Ms^Xm, Ms^Xm, Ms^Xm, Ms^Xm, Ms^Xm, Ms^Xm, Ms^Xm, Xue, Xue, Xue, Xue, Re, Rb^Edb, Uue^Fmf, Rb^Edb, Rb^Edb, Rb^Edb, Ur^Fmf, Rb^Edb, Rb, Xue, Xue, Xue, Xue, Ms^Xm, Ms^Xm, Ms^Xm, Ms^Xm, Ms^Xm, Ms^Xm, Ms^Xm, Ms^Xm, Ms^Xm, Ms^Xm, Ms^Xm, Ms^Xm, Ms^Xm, Ms^Xm, Ms^Xm
Ms^Xm, Ms^Xm, Ms^Xm, Ms^Xm, Ms^Xm, Ms^Xm, Ms^Xm, Ms^Xm, Ms^Xm, Ms^Xm, Ms^Xm, Ms^Xm, Ms^Xm, Ms^Xm, Xue, Xue, Uue^Feth, Uue, Rb, Ur^Fmf, Mm^Vov, Uue^Fdf, Re, Uue^Fmf, Mm^Vov, Uue^Fmf, Ur^Edb, Uue, Uue^Feth, Xue, Xue, Ms^Xm, Ms^Xm, Ms^Xm, Ms^Xm, Ms^Xm, Ms^Xm, Ms^Xm, Ms^Xm, Ms^Xm, Ms^Xm, Ms^Xm, Ms^Xm, Ms^Xm, Ms^Xm, Ms^Xm
Ms^Xm, Ms^Xm, Ms^Xm, Ms^Xm, Ms^Xm, Ms^Xm, Ms^Xm, Ms^Xm, Ms^Xm, Ms^Xm, Ms^Xm, Ms^Xm, Ms^Xm, Ms^Xm, Xue, Xue, Ur, Uhe, Rb^Edb, Uue^Fdf, Ur^Edb, Uue^Fmf, Rb, Uue^Fdf, Ur, Uue^Fdf, Rb^Edb, Uhe, Ur, Xue, Xue, Ms^Xm, Ms^Xm, Ms^Xm, Ms^Xm, Ms^Xm, Ms^Xm, Ms^Xm, Ms^Xm, Ms^Xm, Ms^Xm, Ms^Xm, Ms^Xm, Ms^Xm, Ms^Xm, Ms^Xm
Ms^Xm, Ms^Xm, Ms^Xm, Ms^Xm, Ms^Xm, Ms^Xm, Ms^Xm, Ms^Xm, Ms^Xm, Ms^Xm, Ms^Xm, Ms^Xm, Ms^Xm, Xue, Xue, Xue, Rb^Edb, Rb^Edb, Uue^Fmf, Re^Edb, Re^Edb, Rb, Gll^Edb, Rb, Re, Rb, Uue^Fmf, Re^Edb, Rb^Edb, Xue, Xue, Xue, Ms^Xm, Ms^Xm, Ms^Xm, Ms^Xm, Ms^Xm, Ms^Xm, Ms^Xm, Ms^Xm, Ms^Xm, Ms^Xm, Ms^Xm, Ms^Xm, Ms^Xm, Ms^Xm
Ms^Xm, Ms^Xm, Ms, Ms, Ms, Ms, Ms^Xm, Ms^Xm, Ms^Xm, Ms^Xm, Ms^Xm, Ms^Xm, Ms^Xm, Xue, Xue, Ur, Rb^Edb, Uue^Fdf, Mm^Vov, Ur, Rb, Gll^Edb, 3 Ms^Feta, Gll^Edb, Rb, Uue^Fdf, Mm^Vov, Uue^Fmf, Rb^Edb, Uue, Xue, Xue, Ms, Ms, Ms, Ms^Xm, Ms^Xm, Ms^Xm, Ms^Xm, Ms^Xm, Ms^Xm, Ms^Xm, Ms^Xm, Ms^Xm, Ms^Xm, Ms^Xm
Ms, Ms, Ms, Ms, Ms, Ms, Ms, Ms^Xm, Ms^Xm, Ms^Xm, Ms^Xm, Ms^Xm, Ms^Xm, Xue, Xue, Uue, Rb^Edb, Uue^Fmf, Uue^Fdf, Uue^Fmf, Re, Gll^Edb, Gll^Edb, Gll^Edb, Rb^Edb, Ur, Uue^Fdf, Uue^Fmf, Rb^Edb, Ur, Xue, Xue, Ms, Ms, Ms, Ms^Xm, Ms^Xm, Ms^Xm, Ms, Ms, Ms^Xm, Ms^Xm, Ms^Xm, Ms^Xm, Ms, Ms
Ms, Ms, Ms, Ms, Ms, Ms, Ms, Ms^Xm, Ms^Xm, Ms^Xm, Ms^Xm, Ms^Xm, Ms, Xue, Xue, Xue, Uue, Rb, Rb^Edb, Re^Edb, Ur^Edb, Rb^Edb, Rb^Edb, Rb, Ur, Rb^Edb, Rb, Re^Edb, Ur, Xue, Xue, Xue, Ms, Ms, Ms, Ms^Xm, Ms, Ms^Xm, Ms, Ms, Ms, Ms^Xm, Ms, Ms^Xm, Ms, Ms
Ms, Ms, Ms, Ms, Ms, Ms, Ms, Ms^Xm, Ms^Xm, Ms^Xm, Ms^Xm, Ms, Ms, Ms, Xue, Xue, Uue^Feth, Uhe, Re^Edb, Uue^Fmf, Mm^Vov, Uue^Fdf, Re^Edb, Uue^Fmf, Mm^Vov, Uue^Fdf, Rb, Uhe, Uue^Feth, Xue, Xue, Ms, Ms, Ms, Ms, Ms, Ms, Ms, Ms, Ms, Ms^Xm, Ms^Xm, Ms, Ms, Ms, Ms
Ms, Ms, Ms, Ms, Ha^Fma, Ms, Ms, Ms, Ms^Xm, Ms^Xm, Ms, Ha, Ha, Ha, Aa, Xue, Rb, Rb, Rb, Uue^Fdf, Uue^Fmf, Uue^Fmf, Ur^Edb, Uue^Fdf, Uue^Fmf, Uue^Fmf, Re, Rb, Rb, Xue, Aa^Esa, Ha, Ha, Ms, Ha^Fma, Ha^Fma, Ha^Fma, Ms, Ms, Ms, Ms^Xm, Ms^Xm, Ms, Ms, Ms, Ms
Ha^Fma, Ms, Ha^Fma, Ha^Fma, Ms, Ms, Ms, Ms^Xm, Ms^Xm, Ms^Xm, Ha, Ms, Aa, Aa, Rb^Esa, Rb, Rb, Rb, Uue, Rb^Edb, Re, Rb^Edb, Uhe, Rb, Rb, Rb, Ur, Rb, Aa, Aa^Esa, Aa, Aa, Aa, Ha, Ha, Ha^Fma, Ha^Fma, Ha, Ms, Ms, Ms, Ms, Ms, Ms, Ms, Ms
Ha^Fma, Ha^Fma, Ha^Fma, Ha^Fma, Ms, Ms, Ms, Ms^Xm, Ms, Ms^Xm, Ms, Aa, Ha, Rb^Esa, Gll^Feth, Rb, Aa, Xue, Xue, Ur, Xue, Uue, Uue^Feth, Uue, Xue, Uue, Xue, Xue, Aa^Esa, Aa^Esa, Aa^Feth, Aa^Esa, Aa, Ha, Ha, Ha^Fma, Ha^Fma, Ha^Fma, Ha^Fma, Ms, Ms, Ms, Ha, Ms, Ms, Ms
Ha^Fma, Ha^Fma, Ha^Fma, Ha^Fma, Ms, Ms, Ms, Ms, Ms, Ms, Ha, Aa, Aa, Ur^Esa, Rb^Esa, Rb^Esa, Ha, Xue, Xue, Xue, Xue, Xue, Xue, Xue, Xue, Xue, Xue, Xue, Ha, Aa^Esa, Aa^Esa, Aa, Aa, Aa, Ha, Ha, Ha^Fma, Ha^Fma, Ha^Fma, Ha^Fma, Ha^Fma, Ha, Ha, Ha, Ha, Ha
Ms, Ha, Ha, Ha^Fma, Ha, Ms, Ms, Ms, Ms, Ms, Ha, Aa, Rb^Esa, Rb^Esa, Rb^Esa, Aa, Ha, Ms, Ms^Xm, Xue, Ms, Xue, Ms, Xue, Ms^Xm, Xue, Ms^Xm, Ms, Ha, Aa^Esa, Aa^Esa, Aa, Aa, Ha, Ha, Ha, Ha, Ha^Fma, Ha, Ha^Fma, Ha, Ai, Ai, Ai, Ai, Ha
Ms, Ha, Ai, Ha, Ha, Ms, Ms, Ms, Ms, Ms, Ha, Ai, Ur^Esa, Ur^Esa, Aa^Voa, Ha, Ha, Ms, Ms, Ms, Ha^Fpa, Ms, Ms, Ms^Xm, Ms^Xm, Ms^Xm, Ms, Ms, Ha, Aa^Esa, Aa^Voa, Aa^Esa, Aa, Ai, Aa, Aa, Ha, Ha, Ms, Ha, Ha, Ai, Ai, Ai, Ai, Ai
Ms, Ha, Ai, Ai, Ai, Ha, Ai, Ai, Ai, Ai, Aa, Aa, Ur^Esa, Ur^Esa, Aa, Aa, Ha, Ms, Rb^Esa, Rb^Esa, Rb^Esa, Rb^Esa, Ms, Ms, Ms, Ms^Xm, Ms, Ms, Ha, Ha, Aa^Esa, Aa^Esa, Aa, Aa, Ha, Aa, Ha, Ha, Ms, Ms, Ms, Ha, Ha, Ha, Ha, Ha
Ms, Ms, Ha, Ai, Ai, Ai, Ha, Ai, Ms, Ai, Ha, Ha, Rb^Esa, Ur^Esa, Rb^Esa, Ai, Ha, Ha^Fpa, Rb^Esa, Rb^Esa, Ms, Rb^Esa, Ur^Esa, Aa^Voa, Ms, Ms, Ms, Ha, Aa^Esa, Aa^Esa, Aa, Aa, Aa, Aa, Ms, Ms, Ms, Ms, Ms, Ms, Ms, Ha^Fma, Ha^Fma, Ha, Ms, Ha
Ms, Ms, Ha, Ai, Ai, Ha, Ms, Ms, Ms^Xm, Ha^Fma, Ha, Ha, Ha, Rb^Esa, Rb^Esa, Rb^Esa, Rb^Esa, Rb^Esa, Ha, Ms, Ms, Ms, Rb^Esa, Ur^Esa, Ur^Esa, Ur^Esa, Rb^Esa, Aa^Esa, Aa^Esa, Aa^Esa, Aa^Esa, Aa^Esa, Aa, Ms, Ms, Ms, Ms, Ms, Ms, Ms, Ms, Ha^Fma, Ha^Fma, Ha^Fma, Ms, Ms
Ms, Ms, Ms, Ai, Ai, Ai, Ha^Fma, Ms, Ms^Xm, Ms, Ms, Ha^Fma, Ha^Voa, Ai^Esa, Rb^Esa, Ur^Esa, Aa, Aa, Ha, Ms, Ms, Ms, Ms, Ha^Fpa, Ha^Fpa, Rb^Esa, Ha, Aa^Esa, Aa^Esa, Aa, Aa^Esa, Aa, Ms, Ms, Ms, Ms, Ms, Ms, Ms, Ms, Ms, Ms, Ms, Ms, Ms, Ms
Ms, Ms, Ms, Ha, Ai, Ai, Ai, Ha^Fma, Ms, Ms^Xm, Ms, Ha^Fma, Ha^Fma, Ha, Ur^Esa, Ur^Esa, Ha, Ha, Ha, Ms, Ms, Ms^Xm, Ms^Xm, Ms, Ms, Ms, Ha, Ha, Ha, Aa^Esa, Aa, Aa, Ms, Ms, Ms, Ms, Ms, Ms, Ms, Ms, Ms, Ms, Ms, Ms, Ms, Ms
Ms^Xm, Ms^Xm, Ms, Ha^Fma, Ha^Fma, Ai, Ai, Ha^Vaa, Ha^Fma, Ms, Ha^Fma, Ha^Fma, Ha, Aa, Ur^Esa, Rb^Esa, Aa, Ha, Ha^Fma, Ha^Fma, Ms, Ms, Ms^Xm, Ms^Xm, Ms, Ha, Ha, Aa^Esa, Aa^Esa, Aa^Esa, Aa^Esa, Aa, Aa, Ms, Ms, Ms, Ms, Ms, Ms, Ms, Ms, Ms, Ms, Ms, Ms, Ms
Ms^Xm, Ms^Xm, Ms^Xm, Ha^Fma, Ms, Ha, Ms, Ai, Ha, Ms, Ha, Ha, Aa, Rb^Esa, Rb^Esa, Rb^Esa, Rb^Esa, Rb^Esa, Rb^Esa, Ms, Ha^Fma, Ms, Ms, Ms^Xm, Ms^Xm, Ms, Ha, Rb^Esa, Rb^Esa, Rb^Esa, Aa^Esa, Aa, Aa, Aa, Ms, Ms, Ms, Ms, Ha^Fma, Ms, Ms, Ms, Ms, Ms, Ms, Ms
Ms^Xm, Ms^Xm, Ms^Xm, Ms^Xm, Ms^Xm, Ms, Ha, Ha, Ha, Ha, Ha, Aa, Rb^Esa, Rb^Esa, Rb^Esa, Aa, Ha, Ha, Ha^Fpa, Rb^Esa, Rb^Esa, Ha^Fma, Ms, Ms^Xm, Ha, Ms, Rb^Esa, Rb^Esa, Ha, Rb, Rb^Esa, Aa^Esa, Aa^Esa, Aa, Ha, Ms, Ms, Ms, Ha^Fma, Ms, Ms, Ms, Ms, Ms, Ms, Ms
Ms^Xm, Ms^Xm, Ms^Xm, Ms^Xm, Ms, Ms, Ha, Ha, Aa, Ha, Ai, Rb^Esa, Rb^Esa, Ur^Esa, Ha^Voa, Ai, Ha, Ha, Ha, Ms, Ur^Esa, Ha^Fma, Ms, Ms, Ur^Esa, Ha, Rb^Esa, Rb^Esa, Ms, Aa, Aa, Rb, Rb^Esa, Aa^Esa, Aa, Ha, Ha, Ms, Ha, Aa^Fma, Ha^Fma, Ms, Ms, Ms, Ms, Ms
Ms^Xm, Ms^Xm, Ms^Xm, Ms, Ha^Fma, Ha^Fma, Ha^Fma, Ha, Aa^Esa, Aa, Aa, Rb^Esa, Rb^Esa, Aa, Ha, Ha, Ms, Ms, Ms, Ms, Ha, Ur^Esa, Ur^Esa, Ms, Ur^Esa, Rb^Esa, Ms, Ms, Ms, Aa, Ha, Rb, Ur^Esa, Rb^Esa, Aa, Aa, Ha, Ha, Aa, Ha, Ha, Ms, Ms, Ms, Ms, Ms
Ms^Xm, Ms^Xm, Ms, Ha^Fma, Ha^Fma, Ha^Fma, Ha, Aa, Rb^Esa, Rb^Esa, Rb^Esa, Ur^Esa, Rb^Esa, Ha, Ha, Ha, Ms, Ms^Xm, Ms, Ms, Ha^Fpa, Ur^Esa, Ha^Fma, Ur^Esa, Ha^Fpa, Ha^Fpa, Ms, Ms, Ms, Ha, Ms, Ha, Ur^Esa, Ur^Esa, Rb^Esa, Rb^Esa, Rb^Esa, Aa, Aa, Ha, Ha^Fma, Ms, Ms, Ms, Ms, Ms
Ms, Ms, Ms, Ms, Ha^Fma, Ha^Fma, Ha^Voa, Rb^Esa, Co^Esa, Co^Esa, Coa, Rb^Esa, Aa^Esa, Aa, Ha, Ms, Ms, Ms^Xm, Ms^Xm, Ms, Ms, Ms, Ha^Fpa, Ms, Ha^Fpa, Ms, Ha^Fpa, Ms, Ms^Xm, Ms, Ha, Ha, Ai, Ur^Esa, Co^Esa, Coa, Co^Esa, Rb^Esa, Ha, Ha, Ms, Ms, Ms, Ms, Ms, Ms
Ha^Fma, Ms, Ms, Ms, Ha, Ha, Aa^Esa, Rb^Esa, Co^Esa, 1 Ke, Co^Esa, Rb^Esa, Aa, Ha, Ha, Ms, Ms, Ms^Xm, Ms^Xm, Ms, Ms, Ms, Ms, Ms, Ms, Ha^Fma, Ha^Fma, Ms, Ms^Xm, Ms, Ms, Ha, Ha, Rb^Esa, Coa, 2 Ke, Co^Esa, Rb^Esa, Ha, Ha, Ms, Ms, Ms, Ms, Ms, Ha
Ms^Fma, Ha^Fma, Ha^Fma, Ha, Ha, Aa, Rb^Esa, Rb^Esa, Ur^Esa, Coa, Rb^Esa, Rb^Esa, Ai, Ha, Ha, Ms, Ms, Ms^Xm, Ms^Xm, Ms^Xm, Ms^Xm, Ms, Ms^Xm, Ms, Ms, Ha^Fma, Ha^Fma, Ms, Ms^Xm, Ms, Ms, Ha, Aa, Rb^Esa, Rb^Esa, Co^Esa, Ur^Esa, Rb^Esa, Aa^Esa, Ha, Ha, Ms, Ms, Ms, Ms, Ha
Ha^Fma, Ha^Fma, Ha^Fma, Ha^Fma, Ha, Aa, Rb^Esa, Ur^Esa, Aa, Rb^Esa, Aa^Esa, Aa, Ha, Ha, Ms, Ms, Ms, Ms^Xm, Ms^Xm, Ms^Xm, Ms^Xm, Ms^Xm, Ms, Ms, Ha^Fpa, Ha^Fpa, Ms, Ms, Ms^Xm, Ms^Xm, Ms, Ms, Aa, Aa^Esa, Ha, Rb^Esa, Ur^Esa, Rb^Esa, Aa, Ha, Ha, Ms, Ms, Ms, Ms, Ha
Ha^Fma, Ha^Fma, Ha, Ha, Ai, Rb^Esa, Ur^Esa, Rb^Esa, Ai, Ha, Ha, Ha^Voa, Ha, Ms, Ms, Ms, Ms^Xm, Ms^Xm, Ms^Xm, Ms^Xm, Ms^Xm, Ms^Xm, Ms, Ms, Ha^Fpa, Ha^Fpa, Ha^Fpa, Ms, Ms^Xm, Ms^Xm, Ms^Xm, Ms, Ms, Aa, Ha, Aa, Ha, Rb^Esa, Rb^Esa, Aa, Ha, Ha, Ha, Ms, Ms, Ms
Ha, Ha^Fma, Ha, Ha, Rb^Esa, Rb^Esa, Ur^Esa, Rb^Esa, Ha, Ha, Ha, Ha, Ms, Ms, Ms, Ms, Ms^Xm, Ms^Xm, Ms^Xm, Ms^Xm, Ms^Xm, Ms^Xm, Ms, Ms, Ms, Ha^Fpa, Ms, Ms, Ms^Xm, Ms^Xm, Ms^Xm, Ms, Ms, Ha, Ha, Ha, Aa, Rb^Esa, Rb^Esa, Rb^Esa, Aa, Aa, Ha, Ha, Ha, Ms
Ha, Ha, Ha, Ha, Rb^Esa, Ur^Esa, Ur^Esa, Ai, Ha, Ha, Ha, Ha, Ms, Ms, Ms, Ms^Xm, Ms^Xm, Ms^Xm, Ms^Xm, Ms^Xm, Ms^Xm, Ms^Xm, Ms, Ms, Ms, Ms, Ms^Xm, Ms^Xm, Ms^Xm, Ms^Xm, Ms^Xm, Ms^Xm, Ha, Ms, Ha, Ha, Ha, Ha, Rb^Esa, Rb^Esa, Rb^Esa, Aa, Ha, Ha, Ha, Ha
