Gll^Fmw, Gll^Fp, Gll^Fmw, Gll^Fms, Gll^Fp, Gll^Fp, Gll^Fp, Gll^Fp, Gll^Fp, Gll^Fp, Gll^Fp, Ww, Gll^Fmw, Gll^Fp, Gd^Fp, Gll^Fmw, Hh, Hh, Hh, Mm, Mm, Mm, Ms, Ms, Ms, Mm, Ms, Ms, Ms, Ms, Ms, Mm, Hh, Hh, Hh, Hh, Wo, Wo, Wo, Wo, Wo, Wo, Ww, Ww, Ai, Aa, Gs^Edb, Gs, Gs, Gs, Gs, Gg^Edb, Gs, Ww, Gs, Gs, Gs
Gll^Fmw, Gs^Fmw, Gs^Fmw, Gs^Fmw, Gs^Fp, Gll^Fp, Re^Vc, Gll^Fp, Re^Fp, Gll^Fp, Ww, Ww, Gll^Fmw, Gll^Fmw, Gs^Fmw, Gll^Fp, Hh^Fp, Hh, Hh, Mm, Mm, Mm, Ms, Ms, Ms, Ms, Mm, Mm, Mm, Ms, Mm, Mm, Hh, Hh, Hh, Ww, Ww, Wo, Wo, Wo, Wo^Edt, Wo, Wo, Ww, Ww, Ww, Aa, Gs, Aa, Gs^Edb, Gs^Edb, Aa, Ww, Ww, Gs, Gs, Gs
Gll^Fp, Gll^Fp, Gll^Fp, Gs^Fp, Gs^Fp, Gs^Fp, Gll^Fms, Re^Fp, Gll^Fp, Re^Fp, Ww^Bw\r, Gll^Fp, Gll^Fp, Gs^Fmw, Gs^Fp, Gll^Fp, Gs^Fp, Gll^Fp, Hh^Fp, Hh, Mm, Mm, Ha, Ha, Ww, Ha, Mm, Ha, Hh, Mm, Hh^Vhhr, Mm, Hh, Hh, Wwr, Ww, Ww, Wo, Ww, Wo, Wo, Wo^Edt, Wo^Edt, Wo, Wo, Ww, Ai, Aa, Aa, Gs^Edb, Gs^Edb, Aa, Ww, Aa, Gs^Edb, Gs, Gs
Hh, Hh, Hh, Gll^Fp, Ha, Gll^Fp, Ha, Aa, Ww, Ww, Gll^Fp, Re^Fp, Re^Fp, Gs^Fp, Re^Fp, Gs^Fp, Re^Fp, Gll^Fp, Gll^Fp, Hh, Mm, Mm, Ha, Ww, Ha, Ha, Ha, Ha, Hh, Hh, Hh, Hh, Mm, Mm, Mm, Ww, Ww, Ww^Edt, Ww^Edt, Ww, Ww, Wo^Edt, Wo^Edt, Wo, Wo, Ww, Ww, Aa, Ww, Ww, Ww, Ww, Gs^Edb, Gs^Edb, Chr^Edb, Gs^Edb, Gs
Hh, Hh, Mm, Ha, Ha, Ha, Ha, Ww, Aa, Aa, Hh, Gll^Fms, Gll^Fms, Gll^Fp, Gll^Fp, Re^Vc, Gll^Fmw, Gll^Fp, Gll^Fp, Hh, Hh, Hh, Aa, Ww, Ww, Aa, Hh, Hh, Hh, Hh, Hh, Hh, Mm, Mm, Ww, Ww, Ww^Edt, Ww^Edt, Ww^Edt, Ww, Ww, Wo^Edt, Wo, Wo, Wo^Edt, Wo, Wo, Ww, Ww, Ai, Aa, Aa, Gs^Edb, Chr, Chr, Gs, Re
Mm, Mm, Ms, Mm, Ms, Mm, Ms, Ww, Mm, Hh, Hh, Gll^Fms, Hh, Gs^Fp, Gs^Fp, Gll^Fp, Gll^Fmw, Gll^Fp, Hh^Fp, Hh, Hh, Hh, Hh, Aa, Ww, Aa, Hh, Hh, Aa, Hh, Hh, Hh, Hh, Ww, Ww^Es, Co^Qhh, Co^Qhh, Ww^Edt, Co^Qhh, Wwr^Es, Wwr^Es, Ww^Edt, Wo, Wo, Co^Qhh, Wo^Edt, Wo, Wo, Ww, Ww, Ai, Gs^Edb, Aa^Edb, Gs^Edb, Re^Edb, Re, Chr
Ms, Ms, Ms, Ms, Ms, Ms, Mm, Mm, Mm, Mm, Hh, Hh, Hh^Fp, Hh^Fp, Hh^Fp, Gs^Fp, Gll^Fmw, Gll^Fp, Gll^Fmw, Hh^Fp, Hh, Hh, Gll^Fp, Aa, Ww, Ww, Hh, Aa, Aa, Hh, Hh, Wwr, Wwr, Ww, Wwr^Es, Co^Qhh, Rb, Co^Qhh, Rb, Wwr^Es, Ww^Dr, Co^Qhh, Co^Qhh, Co^Qhh, Co^Qhh, Wo, Wo^Edt, Wo, Wo, Ww, Ww, Ww^Edb, Aa, Gs, Re, Chr^Edb, Chr
Ha, Ha, Ms, Ms, Ha, Mm, Ha, Hh^Vhhr, Hh, Mm, Hh, Hh, Hh, Gll^Fp, Gll^Fp, Gs^Fp, Gs^Fmw, Gll^Fmw, Gll^Fmw, Gll^Fmw, Gll^Fms, Gll^Fp, Gll^Fms, Gll^Fp, Aa, Ww, Wwg^Bw|r, Ww, Ww, Hh, Ww, Wwr, Ww^Edt, Wwr^Es, Wwr^Es, Wwr^Es, Ww, Rb, Rb, Rb^Vo, Rb^Es, Ww^Dr, Ww^Dr, Ww, Ww^Edt, Wo^Edt, Wo, Wo^Edt, Wo, Wo, Ww, Ww, Re, Re, Gs^Edb, Gs^Edb, Gs^Edb
Ha, Ha, Ha, Ms, Ha, Ha, Hh, Hh, Hh, Hh^Fp, Hh^Fp, Gll^Fp, Gll^Fp, Gll^Fp, Gll^Fmw, Gll^Fmw, Gll^Fp, Gs^Fmw, Gll^Fp, Gll^Fp, Gll^Fms, Gll^Fms, Gll^Fp, Gll^Fp, Aa, Aa, Rb, Aa, Ww, Ww, Ww, Ww, Wwr^Es, Ww^Es, Co^Dr, Ww, Rb^Vo, Rb, Rb, Rb, Rb^Es, Ww^Dr, Rb^Vo, Ww, Co^Qhh, Wo, Wo, Wo^Edt, Wo, Wo, Wo^Dr, Ww^Bw/r, Ww, Ai, Ww, Aa, Gs
Ww, Ha, Ww, Ha, Aa, Ha, Hh^Fp, Gd^Fmw, Gll^Fp, Hh^Fp, Gll^Fms, Gll^Fms, Gll^Fmw, Gll^Fp, Gll^Fmw, Gll^Fp, Gll^Fp, Gll^Fms, Gll^Fp, Gll^Fp, Rb^Edt, Gll^Fp, Rb^Edt, Rb^Edt, Rb, Rb, Ce, Rb, Aa, Ww, Ww, Wwr^Es, Co^Qhh, Co^Dr, Rb^Dr, Rb^Dr, Rb^Es, Rb, Ko^Qhh, Ko^Qhh, Ko^Qhh, Rb, Rb, Ww, Rb, Co^Qhh, Wwr, Wo, Co^Qhh, Wo^Bw/r, Wo, Wo, Ww, Ww, Ww, Ai, Ai
Ww, Ww, Ww, Aa, Aa, Hh, Gll^Fmw, Gll^Fp, Gll^Fp, Gll^Fp, Gll^Fp, Gll^Fmw, Gll^Fmw, Gll^Fmw, Gll^Fp, Gll^Fp, Rb, Gll^Fp, 5 Rb^Edt, Gll^Fp, Rb, Rb^Edt, Rb, Rb^Edt, Rb, Rb, Rb, Re^Edt, Ww, Ww, Ww^Edt, Ww^Edt, Ww^Edt, Co^Qhh, Ww^Edt, Rb^Dr, Rb^Es, Rb, Ko^Qhh, 4 Ko^Qhh, Ko^Qhh, Rb, Rb^Es, Rb, Rb, Co^Qhh, Co^Qhh, Ww^Bw/r, Ww, Wo, Wo, Wo^Edt, Wo, Ww, Ww, Ai, Ai
Wo, Wo, Ww, Ww, Hh, Hh^Fp, Gll^Fms, Gll^Fms, Rb^Edt, Rb^Edt, Rb, Rb, Rb^Edt, Rb, Rb^Edt, Gll^Fp, Rb^Edt, Rb^Edt, Rb^Edt, Rb, Rb, Rb, Hh, Rb, Hh, Hh, Rb, Aa, Aa, Aa, Ww, Ww^Edt, Ww^Edt, Ww^Edt, Ww^Dr, Rb^Es, Rb^Vo, Rb, Re, Ko^Qhh, Re, Rb^Es, Rb^Vo, Ww^Es, Wwr^Es, Co^Qhh, Ww, Ww, Ww, Wo, Ww, Wo^Edt, Wo^Edt, Wo, Ww, Ww, Ai
Wo, Wo, Ww, Aa, Mm, Hh, Gll^Fp, Gll^Fp, Rb^Edt, Rb^Edt, Rb, Rb^Edt, Gs^Fp, Rb^Edt, Rb, Rb, Rb^Edt, Rb^Edt, Rb^Edt, Rb, Aa, Hh, Rb, Hh, Hh, Rb, Gs, Gg^Vo, Hh, Aa, Ww, Ww^Edt, Wwr^Es, Ww, Co^Qhh, Rb^Es, Rb^Es, Rb, Re, Kte^Feth, Re, Rb^Es, Rb^Dr, Rb^Dr, Sm^Dr, Wwr^Es, Rb, Rb, Rb^Vo, Rb, Ww, Wo, Wo, Wo^Edt, Wo, Ww, Ww
Wo, Wo, Ha, Mm, Mm, Hh, Hh, Rb^Edt, Rb^Edt, Rb^Edt, Aa, Gll^Fp, Gs^Fms, Gll^Fp, Aa, Rb, Rb, Rb^Edt, Rb, Rb, Rb, Rb, Rb, Ce, Rb, Rb, Gs, Gs, Hh, Hh, Aa, Ww^Edt, Ww, Wwr^Es, Ww, Re^Eqp, Re^Pw\, Re, Re, Re, Rb^Vo, Rb^Es, Rb^Dr, Rb^Dr, Wwr^Es, Ww^Es, Ww^Edt, Ww^Edt, Ww, Rb, Ww, Wo, Wo, Wo^Edt, Wo, Wo, Wo
Wo, Ww, Ha, Hh, Hh, Hh, Gs^Fms, Rb, Rb, Rb, Gs^Fms, Gs^Fms, Gs^Fp, Aa, Aa, Aa, Rb, Rb, Rb, Rb, Rb, Rb, Rb, Rb, Gs, Gs, Gs^Vo, Gs, Gs, Aa, Aa, Ww, Ww, Ww, Rb, Rb, Re, Re^Pw\, Re^Pw\, Rb, Co^Qhh, Co^Qhh, Co^Qhh, Co^Qhh, Wwr^Es, Ww^Edt, Ww^Edt, Rb^Vo, Rb, Ww, Hh, Ww, Wo, Wo, Wo, Wo, Wo
Ww, Ww, Ww, Aa, Aa, Hh, Hh, Gs^Fms, Rb^Edt, Rb, Rb, Gs^Fmw, Rb, Rb, Rb, Rb, Rb, Rb, Hh, Ce, Ce, Rb, Rb, Rb, Gs, Hh, Hh, Gs, Hh, Rb, Rb, Ww, Ww, Ww, Ww^Bw/r, Re, Rb, Rb, Rb, Re^Eqp, Ww^Edt, Ww^Edt, Ww^Edt, Co^Qhh, Ww, Ww^Edt, Ww, Rb, Rb, Hh, Hh, Ww, Ww, Wo, Ww, Wo, Wo
Ha, Aa, Ww, Aa, Aa, Hh, Gs^Fp, Gs^Fms, Rb, Rb, Rb, Rb, Gs, Rb, Ce, Rb, Hh, Hh, Ce, 3 Ke, Hh, Rb, Rb, Gs, Aa, Aa, Hh, Hh, Hh, Rb, Hh, Ww, Rb, Ww^Bw/r, Ww^Bw/r, Ww^Bw/r, Ww, Ww, Ww, Ww, Ww^Edt, Ww^Edt, Ww, Ww, Ww, Ww, Rb, Ww, Rb, Hh, Ww, Ww, Ww, Ww, Ww, Wo, Wo
Ha, Ha, Ha, Ww, Aa, Aa, Gs^Fp, Rb, Rb, Ce, Rb, Aa, Gs, Rb, Rb, Rb, Hh, Hh, Hh, Ce, Hh, Rb, Rb, Rb, Ww, Hh, Aa, Hh, Hh^Vo, Hh, Aa, Ww, Rb, Rb, Rb, Ww, Rb, Ww, Rb, Hh, Hh, Hh, Ww, Rb, Rb, Rb^Edt, Rb^Edt, Ww, Ww^Bw|r, Ww, Rb^Gvs, Ww, Ww, Ww, Ww, Wo, Wo
Mm, Mm, Hh, Hh, Gs^Fp, Gs^Fms, Gs^Fp, Rb, Gs, Rb, Aa, Aa, Gs^Vo, Gs, Hh, Hh, Hh, Hh, Aa, Hh, Aa, Rb, Ww, Rb, Ww, Aa, Aa, Hh, Hh, Hh, Ww, Rb, Rb, Rb, Hh, Ww, Rb, Rb^Vo, Rb, Hh, Hh, Ww^Edt, Ww, Rb, Aa, Rb^Vo, Rb^Edt, Wwg, Rb^Gvs, Rb^Gvs, Aa, Rb^Gvs, Rb^Gvs, Ww, Ww, Wo, Wo
Hh, Hh, Hh, Gll^Fp, Gs^Fmw, Gs^Fp, Gs^Fmw, Rb, Gs, Gs, Rb, Rb, Aa, Gs, Hh, Hh, Gs, Hh, Aa, Aa, Aa, Ww, Gs, Rb, Rb, Ww, Aa, Aa, Aa, Aa, Rb, Rb, Rb, Rb, Hh, Hh, Ww, Rb, Ce, Rb, Ww, Ww, Rb^Gvs, Rb^Gvs, Rb^Gvs, Rb^Gvs, Wwg, Wwg, Rb^Gvs, Rb^Gvs, Aa, Aa, Rb^Gvs, Rb, Rb, Ww, Wo
Gll^Fmw, Gll^Fmw, Gll^Fp, Gll^Fp, Rb, Rb, Rb, Rb, Gs, Gs, Hh, Aa, Aa, Ww, Ww, Gs, Aa, Ww, Gs, Gs, Gs, Gs, Gs, Rb, Rb, Rb, Rb, Rb, Rb, Rb, Rb, Rb, Rb, Hh, Ww, Ww, Rb^Gvs, Rb^Gvs, Rb^Gvs, Ww, Rb^Gvs, Rb, Rb, Rb^Gvs, Aa, Aa, Aa, Rb^Gvs, Rb, Rb^Gvs, Rb^Gvs, Rb^Gvs, Wwg, Rb, Ww, Ww, Ww
Gll^Fp, Gll^Fms, Gll^Fms, Rb, Gs^Vo, Gs, Gs, Hh, Hh, Hh, Hh, Aa, Ww, Aa, Rb, Rb, Aa, Aa, Aa, Rb, Gs, Rb^Vo, Rb, Rb, Aa, Rb, Aa, Rb, Rb, Rb, Rb, Aa, Aa, Aa, Ww, Ww, Rb^Gvs, Rb^Gvs, Rb^Gvs, Rb^Gvs, Rb, Rb^Gvs, Rb, Rb^Gvs, Rb^Gvs, Wwg, Ww, Ww, Rb^Gvs, Rb^Gvs, Rb, Rb^Gvs, Rb^Gvs, Ww, Ww, Ww, Ww
Rb, Rb, Rb, Rb, Gs, Gs, Hh, Hh, Hh, Hh, Hh, Hh, Gs, Gs, Gs, Rb, Ww, Ww, Aa, Rb, Gs, Gs, Rb, Rb, Hh, Aa, Rb, Rb, Rb, Rb^Vo, Hh, Hh, Ce, Rb, Rb^Gvs, Rb^Gvs, Wwg, Aa, Aa, Ww, Ww, Rb^Gvs, Rb^Gvs, Rb, Aa, Aa, Aa, Rb, Wwg, Rb^Gvs, Ww, Rb^Gvs, Rb^Vo, Rb, Aa, Ww, Ww
Ww, Gs, Gs, Gs, Gs, Gs, Hh, Hh, Hh, Hh, Hh, Gs, Gs, Gs^Vo, Gs, Gs, Gs, Ww, Aa, Aa, Gs, Rb, Rb, Hh, Rb^Gvs, Hh, Rb^Gvs, Rb^Gvs, Rb, Hh, Hh, Rb, Rb, Rb^Gvs, Rb^Gvs, Rb^Gvs, Rb, Wwg, Aa, Ww, Ww, Rb, Rb^Gvs, Rb, Rb, Aa, Rb^Gvs, Rb^Gvs, Rb^Gvs, Wwg, Ww, Rb^Gvs, Rb, Rb^Edt, Aa, Ww, Wo
Ww, Ww, Aa, Gs, Gs, Gs, Gs, Rb, Rb, Rb, Rb, Rb, Aa, Gs, Hh, Hh, Gs, Gs, Gs, Gs, Gs, Rb, Rb, Rb, Rb^Gvs, Rb^Gvs, Aa, Aa, Rb, Rb, Hh, Hh, Rb, Rb^Gvs, Rb^Gvs, Rb^Gvs, Rb^Gvs, Aa, Rb^Gvs, Aa, Rb, Rb^Gvs, Rb^Gvs, Rb^Gvs, Rb, Rb^Gvs, Rb^Gvs, Rb^Gvs, Rb^Gvs, Rb^Gvs, Rb, Ww, Ww, Aa, Ww, Ww, Wo
Aa, Aa, Ww, Ww, Ww, Gs, Gs, Rb, Rb, Aa, Aa, Aa, Aa, Ww, Gs, Hh, Gs, Gs, Rb, Rb, Rb, Rb, Rb, Rb^Gvs, Rb^Gvs, Aa, Rb^Gvs, Aa, Aa, Ce, 2 Ke, Ce, Hh, Rb, Rb, Rb^Vo, Rb, Rb^Gvs, Rb^Gvs, Rb^Gvs, Rb^Gvs, Rb^Gvs, Rb, Rb^Vo, Rb^Gvs, Rb, Rb, Rb, Rb, Rb, Ww, Ww, Wo, Wo, Wo, Wo, Wo
Aa, Aa, Aa, Aa, Aa, Gs, Hh, Gs, Gs, Ww, Gs, Gs, Gs, Gs, Gs, Gs, Gs, Gs, Rb, Rb, Rb, Rb, Rb^Gvs, Rb^Gvs, Rb^Gvs, Rb^Gvs, Rb^Gvs, Rb, Hh, Ce, Hh, Ce, Rb, Rb, Rb^Gvs, Rb, Rb, Rb, Rb, Rb, Rb, Rb, Rb^Gvs, Rb^Gvs, Rb^Gvs, Rb^Gvs, Rb, Ww, Ww, Ww, Ww, Ww, Wo, Wo, Wo, Wo, Ww
Aa, Hh, Hh, Hh, Hh, Hh, Hh, Hh, Gs, Gs, Gs, Gs, Gs, Gs, Gs, Gs, Gs, Rb, Rb, Rb, Gs, Rb^Gvs, Rb^Gvs, Rb^Gvs, Rb^Gvs, Rb^Gvs, Ce, Rb, Hh, Hh, Hh, Hh, Rb^Gvs, Rb^Gvs, Rb^Gvs, Rb^Gvs, Rb^Gvs, Rb^Gvs, Rb^Gvs, Rb, Rb, Rb^Gvs, Rb^Gvs, Rb^Gvs, Rb^Gvs, Rb^Gvs, Aa, Ww, Wo, Wo, Wo, Wo, Wo, Wo, Ww, Ww, Ai
Hh, Hh, Hh, Hh, Hh, Hh, Hh, Hh, Hh, Gs, Aa, Ce, Ce, Rb, Rb, Rb, Rb, Rb, Rb, Gs, Gs, Gs, Rb^Gvs, Rb^Gvs, Rb^Gvs, Rb^Gvs, Rb^Gvs, Rb^Gvs, Rb^Gvs, Rb^Gvs, Rb^Gvs, Rb^Gvs, Aa, Rb^Gvs, Aa, Rb^Gvs, Rb^Gvs, Rb^Gvs, Rb^Gvs, Rb^Gvs, Rb, Ww, Aa, Rb^Gvs, Rb^Gvs, Aa, Aa, Wo, Wo, Wo, Wo, Wo, Ai, Ww, Ww, Ai, Ai
Hh, Hh, Hh, Hh, Hh, Hh, Hh, Hh, Aa, Aa, Rb, Ce, 1 Ke, Ce, Ce, Rb, Rb, Rb, Gs, Gs, Gs, Gs, Rb^Gvs, Rb^Gvs, Rb^Gvs, Rb^Gvs, Rb^Gvs, Rb^Vo, Rb^Gvs, Rb^Gvs, Rb^Gvs, Rb^Gvs, Aa, Aa, Aa, Rb, Rb^Gvs, Rb^Gvs, Rb^Gvs, Rb^Gvs, Rb^Gvs, Ww, Ww, Rb, Rb^Gvs, Aa, Wo, Wo, Wo, Wo, Ww, Ww, Aa, Ai, Gll^Fp, Ww, Ai
Hh, Hh, Hh, Hh, Hh, Aa, Aa, Hh, Aa, Aa, Rb, Ce, Ce, Ce, Gs, Gs, Gs, Gs, Aa, Rb, Aa, Gs, Gs, Rb^Gvs, Rb^Gvs, Rb^Gvs, Rb^Gvs, Rb^Gvs, Rb^Gvs, Rb^Gvs, Rb^Gvs, Aa, Aa, Wwg, Rb^Gvs, Aa, Rb^Gvs, Rb^Gvs, Rb^Gvs, Rb^Gvs, Aa, Ww, Ww, Ww, Ww, Ww, Wo, Wo, Wo, Ww, Ww, Ai, Aa, Gs, Gll^Fp, Gs, Gll^Fp
Hh, Hh, Hh, Hh, Hh, Aa, Aa, Aa, Gs, Gs, Rb, Rb, Gs, Gs, Gs, Gs, Aa, Aa, Aa, Rb, Ww, Aa, Aa, Rb, Rb^Gvs, Ce, Rb^Gvs, Rb^Gvs, Rb^Gvs, Rb^Gvs, Rb^Gvs, Rb^Gvs, Rb^Gvs, Rb^Gvs, Rb, Rb^Gvs, Rb, Rb^Gvs, Rb^Gvs, Rb^Gvs, Rb, Aa, Rb, Ww, Ww, Wo, Wo, Wo, Ww, Ww, Ai, Ai, Gs^Fms, Gs, Gll^Fp, Gll^Fp, Gs^Fms
Hh, Hh, Hh, Gs, Gs, Aa, Aa, Aa, Gs, Rb, Rb, Rb, Gs, Gs, Gs, Gs, Aa, Aa, Aa, Aa, Ww, Aa, Ai, Rb, Rb, Rb^Gvs, Rb^Gvs, Rb^Gvs, Rb^Gvs, Rb^Gvs, Rb^Gvs, Rb^Gvs, Rb^Gvs, Rb^Gvs, Rb, Ww, Ww, Rb^Gvs, Rb^Gvs, Rb^Gvs, Rb^Gvs, Rb^Gvs, Aa, Ww, Wo, Wo, Wo, Wo, Ww, Ww, Gs, Gs, Gs^Fms, Gs^Fms, Gs^Fms, Gll^Fp, Gs^Fms
Gs, Gs, Gs, Gs, Gs, Aa, Gs, Gs, Gs, Rb, Rb, Gs, Gs, Gs, Gs, Aa, Aa, Ai, Ww, Ai, Ww, Ww, Ai, Ai, Ww, Ww, Ww, Rb, Rb, Rb, Aa, Rb^Gvs, Aa, Rb, Ww, Ww, Ww, Rb, Rb^Gvs, Aa, Aa, Aa, Ai, Wo, Wo, Wo, Ww, Ww, Ai, Gs^Fms, Gll^Fp, Gs, Gs, Gs^Fms, Gll^Fp, Gs^Fms, Gs^Fms
Gs, Gs, Gs, Gs, Gg, Gs, Gs, Gs, Rb, Rb, Rb, Gs, Gs, Gs, Aa, Aa, Wwg, Ww, Ww, Ww, Ww, Ww, Ww, Ww, Ww, Ww, Ww, Ww, Ww, Aa, Aa, Aa, Wwg, Wwg, Ww, Ww, Ww, Ww, Ww, Wwg, Wwg, Aa, Sm, Wo, Wo, Ww, Ww, Ww, Sm, Gs^Fms, Gs^Fms, Gs, Gs^Fms, Gll^Fp, Gll^Fp, Gll^Fp, Gs^Fms
