Gll^Fp, Gll^Fp, Gll^Fp, Gll^Fms, Aa^Fp, Gll^Fp, Aa^Fp, Aa^Fp, Gll^Fp, Gll^Fp, Gll^Fp, Gll^Fp, Gll^Fp, Aa^Fp, Aa^Fp, Aa^Fp, Gll^Fp, Aa^Fp, Gll^Fp, Gll^Fp, Gll^Fp, Gll^Fms, Mm, Mm, Mm, Gll, Mm, Mm, Mm, Gll, Mm, Gll, Hh, Gll^Fp, Gll^Fp, Gll^Fmw, Wwg, Wwg, Wwg, Wwg, Wog, Wog, Ai, Aa, Aa, Hh, Aa, Ai, Aa, Aa, Mm, Mm, Hh, Hh, Hh, Hh, Hh
Aa^Fp, Gll^Fp, Gll^Es, Gll^Fp, Gll^Fp, Aa^Fp, Aa^Fp, Aa^Fp, Gll, Gll^Fp, Gll^Fp, Gll^Fp, Wwg, Gll^Fms, Gll^Fp, Gll^Fmw, Gll^Fms, Gll^Fp, Gll^Fp, Hh, Mm, Mm, Ms, Mm, Hh, Hh, Gll^Fp, Mm, Gll^Fms, Mm, Wwrg, Hh, Aa^Fp, Gll^Fp, Gll^Fms, Rb^Edt, Rb^Edt, Wwg, Wwg, Wwg, Wwg^Edt, Wog, Wog, Ai, Wwg, Aa^Esa, Wwg, Wwg, Aa, Hh, Mm, Mm, Aa, Hh, Ai, Hh, Hh
Gll^Fp, Gs, Gll^Fmw, Gll^Fmw, Gll^Fp, Aa^Fp, Gll^Fp, Gll^Fp, Gll^Es, Gll^Fms, Gll^Fp, Wwg, Wwg, Gll^Fp, Gll^Fp, Gll, Gll^Fmw, Gll^Fp, Hh, Mm, Mm, Ms, Ms, Mm, Mm, Hh, Hh, Gll^Fp, Gll^Fp, Hh^Esa, Aa^Fp, Wwf, Gll^Fp, Rb^Esa, Rb^Edt, Rb^Edt, Co, Wwg, Cer, Wwg, Wwg, Wog^Edt, Wog, Wog, Wog, Wwg, Aa, Aa^Esa, Hh, Mm, Hh, Aa, Wwg, Ai, Hh, Hh, Mm
Hh, Hh, Gll^Fp, Gll^Fms, Gs^Fp, Gll^Fp, Hh, Hh, Gll^Fp, Gll^Fp, Gll^Fp, Gll^Fp, Gll^Fp, Gll^Fp, Gll^Fp, Aa^Fp, Aa^Fp, Aa^Fp, Gll^Fp, Hh, Mm, Ms, Mm, Wwg, Hh, Gll^Fp, Gll^Fp, Gll^Fp, Gll^Fp, Gll^Fp, Gll^Fp, Wwf, Rb^Edt, Rb^Edt, Rb^Dr, Wwg, Wwrg, Cer^Dr, Rb^Edt, Rb^Edt, Wwrg, Ai, Wog, Wog, Wog, Ai, Wwg, Gs, Gs, Hh, Aa, Aa, Wwg, Aa, Hh, Mm, Mm
Mm, Mm, Mm, Hh, Mm, Hh, Mm, Hh, Hh, Hh, Hh, Gll^Fmw, Gll^Fp, Gll, Gll^Es, Gll^Fp, Aa^Fms, Aa^Fp, Gll^Fp, Gll^Fp, Mm, Hh, Gll^Fp, Wwg, Wwf, Gll^Fp, Gll, Gll^Fp, Gll^Fp, Gll, Rb^Edt, Wwg, Wwg^Bp/, Rb^Edt, Wwg, Wwrg, Wwrg, Wwg, Sm, Rb^Vo, Wwg, Co, Wwg^Dr, Wog^Edt, Wwg, Wwg, Wwg, Wwg, Ai, Aa, Wwg, Wwg, Aa^Esa, Aa, Mm, Mm, Mm
Gll, Mm, Mm, Mm, Mm, Mm, Ms, Ms, Ms, Mm, Mm, Mm, Mm, Hh, Gll^Fp, Gll^Fp, Aa^Fp, Gll^Fmw, Hh, Hh, Mm, Gll^Fp, Aa^Fp, Aa^Fp, Wwf^Esa, Gll^Fp, Gll^Fp, Gll^Fp, Rb^Edt, Rb^Edt, Cer, Wwg^Dr, Rb^Edt, Wwf, Wwf, Chw, Ch, Wwg, Cer, Wwg, Wwrg, Wwg^Edt, Wwg^Edt, Wwg, Chw, Wwg, Wwg, Wog, Ai, Aa^Esa, Wwg, Aa, Aa^Esa, Hh, Hh, Mm, Mm
Mm, Mm, Mm, Mm, Mm, Ms, Mm, Ms, Mm, Hh, Hh, Mm, Hh, Hh, Hh, Gll^Fp, Gll^Fp, Gll^Fp, Gll^Fp, Hh, Hh, Hh, Gll^Fp, Aa^Fp, Wwf, Aa^Fp, Gll^Fms, Gll^Fp, Rb^Edt, Cer, Rb^Edt, Rb^Edt, Wwg, Wwf, Wwg, Chw, Rb^Edt, Co, Rb^Edt, Co, Rb^Es, Co^Dr, Co, Ch, Chw, Wwg^Dr, Wwg, Wog, Wog, Wwg, Wwg, Ai, Gs, Hh, Hh, Hh, Hh
Hh, Mm, Hh, Mm, Mm, Mm, Mm, Mm, Mm, Hh, Gll^Es, Gll^Fp, Gs^Fp, Gll^Fp, Gll^Fmw, Gll^Fp, Gll^Es, Gll^Fp, Gll^Fp, Gll^Fp, Gll^Fmw, Gll^Fmw, Gs, Gll^Fp, Gll^Fp, Wwf, Wwg, Wwg, Wwg, Rb^Dr, Rb^Edt, Rb^Vo, Rb^Es, Wwg, Wwg, Cer^Dr, Sm^Dr, Rb^Edt, Rb^Edt, Rb^Vo, Rb^Es, Rb^Edt, Rb^Edt, Rb^Edt, Cer, Wwrg, Ai^Esa, Wog, Wog, Wog, Wwg, Aa, Aa^Esa, Hh, Aa, Ai, Ai
Aa^Fp, Hh, Mm, Mm, Mm, Mm, Hh, Mm, Mm, Hh, Hh, Gll^Fp, Gll^Fp, Gll^Fp, Gll^Fp, Gll^Fp, Gll^Fp, Gll^Fp, Gll^Fp, Gll^Fp, Gll^Fp, Gll^Fp, Gll^Fp, Gll^Fp, Gll^Fp, Gll^Fmw, Gll^Fp, Gll^Fp, Wwg, Cer, Rb^Edt, Rb^Es, Wwf, Wwrg, Co, Sm^Dr, Rb^Vo, Rb^Edt, Re, Re^Edt, Re^Edt, Rb^Edt, Rb^Vo, Rb^Edt, Cer, Wwrg, Wwg, Ai, Wog^Edt, Wog^Edt, Wog, Aa, Aa^Esa, Aa, Wwg, Wwg, Aa
Aa^Fp, Aa^Fp, Hh, Mm, Hh, Hh, Hh, Gll^Fp, Gll^Fp, Hh, Gll^Fp, Gll^Fmw, Gs, Gll, Gll^Fp, Gll^Fp, Gll^Fp, Gll^Fp, Re^Edt, Gll^Fp, Rb^Edt, Gs^Edt, Re^Edt, Gll^Vo, Re^Fp, Gll^Fp, Gll, Rb^Edt, Rb^Edt, Wwg^Bp|, Wwg, Wwf, Chw, Chw, Rb^Edt, Rb^Edt, Re, Re^Edt, Ko, Ko, Ko, Re, Rb^Es, Rb^Edt, Rb^Edt, Co, Wwf, Wwrg, Co, Wog^Edt, Wog, Wwg, Aa, Ai, Wwg, Ai, Hh
Wwg, Wwg, Wwg, Aa^Fp, Aa^Fp, Gll^Fp, Gll^Fp, Gll^Fmw, Gll^Fp, Gll^Fp, Re^Edt, Gll^Fp, Rb^Edt, Gll^Fp, Gll^Fp, Gll^Fp, Rb^Edt, Rb^Edt, 5 Rb^Edt, Rb^Edt, Rb^Edt, Rb^Edt, Re^Edt, Re^Edt, Cer, Re, Rb^Es, Rb^Edt, Rb^Edt, Rb^Edt, Wwg, Wwg, Wwg, Ch, Co, Rb^Edt, Rb^Edt, Re, Ko, 4 Ko, Ko, Re, Rb^Es, Rb^Es, Rb^Edt, Ch, Chw, Wwg^Edt, Wwg^Edt, Wwrg^Edt, Ai, Wwg, Wwg, Wwg, Aa, Hh, Hh
Wwg, Wwg, Wwg, Wwg, Aa^Fp, Aa^Fp, Gll^Fp, Re^Edt, Rb^Edt, Rb^Edt, Rb^Edt, Rb^Edt, Rb^Edt, Rb^Edt, Rb^Edt, Re^Edt, Re^Edt, Re^Edt, Re^Edt, Rb^Edt, Re, Rb^Edt, Gll^Edt, Re, Re, Re^Es, Gll^Es, Rb^Es, Rb^Edt, Co, Rb^Edt, Rb^Es, Rb^Es, Wwf, Sm^Dr, Rb^Es, Rb^Vo, Re, Re^Edt, Ko, Re, Re^Edt, Rb^Vo, Rb^Edt, Co, Chw, Wwg, Wwg^Edt, Wwg^Edt, Wwg^Dr, Wwg^Edt, Wwg, Wog^Edt, Wwg, Wwg, Aa, Aa
Aa^Fp, Aa^Fp, Hh^Esa, Gs^Fp, Gll^Fp, Gll^Fp, Gll^Fp, Gll^Fp, Gll^Fp, Rb^Edt, Rb^Edt, Rb^Edt, Gll^Fp, Rb^Edt, Re^Edt, Rb^Edt, Re, Re, Re^Edt, Re, Gll, Gll^Vo, Re, Re, Re, Rb, Gll^Vo, Rb^Edt, Rb^Edt, Co, Rb^Edt, Rb^Es, Wwrg, Sm, Co^Dr, Rb^Es, Rb^Edt, Rb^Edt, Re, Kte^Feth, Rb^Edt, Re, Rb^Edt, Rb^Edt, Sm^Dr, Wwf^Es, Rb^Es, Rb^Edt, Rb^Edt, Cer, Wwrg, Wwrg^Edt, Wog^Edt, Wog, Wwg, Aa, Wwg
Aa^Fp, Aa^Esa, Hh, Hh, Hh, Gs^Fp, Gll^Fms, Gll^Fp, Aa^Fp, Re^Edt, Rb^Esa, Re, Gll^Fp, Re, Re^Vo, Rb, Co, Re, Rb^Es, Re, Re, Rb, Re, Cer, Re, Gll^Edt, Gs, Gs^Edt, Gs, Rb^Dr, Rb^Edt, Rb^Edt, Wwg, Wwg, Sm, Xom, Re^Pw\, Re, Re, Re, Rb^Vo, Rb^Edt, Rb^Edt, Co^Dr, Sm, Wwf^Es, Rb^Edt, Rb^Vo, Rb^Bp|, Rb^Dr, Rb^Edt, Wwrg^Edt, Wwg^Edt, Wog^Edt, Wog, Wwg, Wog
Gll^Fms, Gll^Fp, Gll^Fmw, Hh, Gll^Fp, Gll^Fmw, Gll^Fms, Gll^Fp, Aa, Aa, Aa, Gll^Fp, Re, Gs^Edt, Rb, Rb^Es, 2 Ko, Rb^Es, Rb, Re, Cer, Re, Rb^Es, Re, Rb, Rb, Gs, Gs, Wwg, Rb^Edt, Rb^Edt, Rb^Vo, Rb^Edt, Wwg, Rb^Edt, Rb^Edt, Re, Re^Pw\, Re^Pw\, Rb^Edt, Cer^Dr, Co, Ch, Chw, Wwrg, Wwg^Edt, Wwg^Edt, Rb^Edt, Cer, Rb^Es, Rb^Es, Wwg, Wwrg, Wog^Edt, Wwg, Wog, Wog
Gll^Fp, Gll^Fp, Gll^Fp, Gll^Fp, Gll^Fp, Hh, Hh, Gll^Fp, Re, Re^Esa, Re, Re, Cer, Re, Rb^Es, Co, Rb, Co, Rb, Re, Re, Re^Es, Gll, Gll, Rb, Ai, Wwf, Rb, Rb, Rb, Rb^Edt, Rb^Dr, Co, Rb^Edt, Rb^Edt, Re, Re, Rb^Edt, Rb^Edt, Xom, Wwf^Es, Sm, Wwg, Chw, Wwg, Wwg^Edt, Wwg^Edt, Rb^Edt, Cer, Rb^Es, Rb^Edt, Rb^Edt, Wwg, Wwg, Wwg, Wwg, Wwrg
Gll^Fp, Gll^Fmw, Gs, Gs, Hh, Hh, Gll^Fp, Rb^Es, Re, Cer, Re, Re^Es, Re^Es, Re, Gs^Es, Rb^Es, Gll, Rb^Es, Rb, Gs, Gs^Edt, Re^Vo, Re, Gs, Wwg, Aa, Ai, Rb, Rb, Gs, Gs, Rb^Edt, Rb^Edt, Rb^Edt, Re, Re, Rb^Edt, Rb^Es, Rb^Es, Wwf, Wwf, Wwg, Rb^Edt, Wwrg, Rb^Es, Wwg, Rb^Bp/, Co, Rb^Edt, Rb^Edt, Rb^Gvs, Rb^Edt, Rb^Edt, Wwg, Wwg, Wwrg, Wwrg
Hh, Gll^Fp, Hh, Gs, Gs, Gll^Fp, Gll^Fp, Rb, Rb^Es, Re, Rb, Rb, Rb, Gll, Gs, Gll, Gs, Gll, Rb, Rb, Aa, Gs^Edt, Re, Rb, Rb, Aa^Esa, Rb, Gs, Gs, Gs, Gs, Rb, Re, Rb, Re^Edt, Rb, Rb, Rb^Es, Rb^Bp\, Rb^Edt, Rb^Edt, Rb^Edt, Rb^Bp/, Rb^Es, Rb^Es, Rb^Edt, Rb^Edt, Rb^Edt, Rb^Gvs, Rb^Edt, Rb^Gvs, Rb^Gvs, Wwg, Wwg, Wwg, Wwg, Wwg
Hh, Hh, Hh, Hh, Gs, Gs, Gs, Rb, Gll, Gll, Gs, Rb^Vo, Rb^Edt, Rb, Gs, Gs, Gs^Esa, Wwg, Aa^Esa, Aa, Ai, Rb, Re, Hh, Hh, Hh, Gs^Edt, Gd^Vo, Gs, Gs, Re, Re, Re^Edt, Re^Edt, Re^Edt, Rb, Rb, Rb^Edt, Rb, Co, Co, Co, Rb^Edt, Rb^Vo, Rb, Rb^Dr, Rb^Gvs, Rb^Gvs, Rb^Gvs, Rb^Gvs, Rb^Gvs, Rb^Gvs, Rb^Gvs, Rb^Gvs, Wwg, Wwg, Wwg
Hh, Hh, Hh, Hh, Gs, Gs, Gs, Gs, Hh, Gll, Gs, Re^Edt, Rb, Gs, Hh, Hh, Gs, Aa, Aa, Wwf, Aa, Gs^Esa, Re, Aa, Aa, Hh, Gs, Gs, Gs, Re, Re, Re, Gs, Rb, Re, Rb, Rb^Gvs, Rb^Gvs, Rb^Gvs, Rb, Rb^Gvs, Rb^Edt, Rb^Gvs, Re^Es, Rb^Gvs, Rb^Gvs, Rb^Gvs, Rb^Gvs, Rb^Gvs, Rb^Gvs, Rb^Gvs, Rb^Gvs, Aa^Gvs, Rb^Gvs, Rb^Gvs, Wwg, Wwg
Gs, Gs, Gs, Gs, Gs, Hh, Hh, Hh, Hh, Hh, Gs, Re, Re, Gs, Hh, Hh, Gs, Rb, Wwf, Wwg, Gs, Wwf, Gs, Re, Rb, Wwf, Rb, Rb, Rb, Re, Rb, Rb, Aa^Es, Re^Es, Cer, Re, Rb^Gvs, Rb^Gvs, Rb^Gvs, Rb^Gvs, Rb^Gvs, Rb^Gvs, Re, Re^Es, Rb^Gvs, Rb^Gvs, Rb^Gvs, Rb^Gvs, Rb^Gvs, Rb^Gvs, Rb^Gvs, Wwg, Aa^Gvs, Aa^Esa, Sm, Wwg, Wwg
Aa, Ai, Aa, Gs, Hh, Hh, Gs, Hh, Gs, Hh, Gs, Gs, Re^Edt, Gd^Vo, Gs^Edt, Hh, Gs, Hh, Gs, Rb, Rb, Rb, Re, Re, Re^Edt, Re^Edt, Re^Edt, Re^Edt, Rb^Edt, Rb, Rb, Gs, Re, Re, Re, Re, Re^Vo, Rb^Gvs, Re^Es, Re, Re, Re, Rb^Gvs, Rb^Gvs, Rb^Gvs, Wwg, Aa^Gvs, Wwg, Wwf, Aa^Gvs, Sm, Rb^Gvs, Rb^Gvs, Sm^Esa, Sm, Wwg, Wog
Aa, Aa^Esa, Aa, Gs^Esa, Rb^Edt, Gs, Rb, Gs^Esa, Aa, Rb, Wwf, Rb, Gs^Esa, Re, Re, Aa, Re, Gs, Rb, Rb, Rb, Re, Re, Re, Gs^Fmw, Re, Gs^Fmw, Rb, Gs^Es, Rb, Rb, Re, Cer, Re, Rb^Gvs, Rb^Gvs, Rb^Gvs, Re, Rb^Gvs, Rb^Esa, Rb^Gvs, Rb^Gvs, Wwg, Rb^Esa, Aa^Gvs, Aa^Gvs, Aa^Gvs, Aa^Gvs, Rb^Esa, Rb^Gvs, Rb^Gvs, Rb^Gvs, Rb^Gvs, Rb^Gvs, Rb^Gvs, Wwg, Wog
Wwf, Wwg, Gs, Gd^Vo, Gs^Edt, Rb^Edt, Rb, Aa^Esa, Aa^Esa, Aa, Ai, Rb, Rb, Gs, Hh, Re, Hh, Re, Rb, Rb, Re, Gs, Gs, Gs^Fmw, Gs^Fmw, Gs^Fmw, Gs, Gs^Es, Re^Es, Gs, Rb, Re, Re^Es, Re, Rb^Gvs, Rb^Gvs, Aa^Gvs, Wwg, Aa^Gvs, Aa^Gvs, Rb^Gvs, Rb^Gvs, Rb^Gvs, Wwf, Aa^Gvs, Aa^Gvs, Aa^Gvs, Aa^Gvs, Aa^Gvs, Rb^Gvs, Rb^Gvs, Rb^Gvs, Aa^Gvs, Sm, Ai, Wwg, Wog
Hh, Gs, Hh, Gs, Hh, Gs, Gs, Gs, Rb, Wwf, Rb, Rb, Gs, Gs, Gs, Hh, Re, Re, Rb, Gs, Re, Re^Vo, Gs, Aa, Re^Edt, Re, Re, Re, Cer, Re, Re, Re, Re^Es, Re^Es, Re, Rb^Esa, Aa^Gvs, Aa^Gvs, Aa^Gvs, Wwf, Wwg, Rb^Gvs, Rb^Gvs, Aa^Gvs, Rb^Esa, Aa^Gvs, Wwg, Aa^Gvs, Aa^Gvs, Wwg, Sm, Sm, Rb^Gvs, Rb^Gvs, Wwg, Wwg, Wog
Hh, Hh, Hh, Hh, Hh, Hh, Gs, Gs, Gs, Rb, Rb, Gs, Rb, Gs, Rb, Re, Re^Edt, Rb^Edt, Gs, Gs, Gs, Re, Re, Gs, Re, Cer, Re, Re, Re, Re, Re^Es, Co, 3 Ko, Co, Re^Es, Rb^Gvs, Rb^Gvs, Aa^Gvs, Rb^Esa, Wwg, Rb^Gvs, Sm, Sm, Rb^Gvs, Rb^Gvs, Rb^Gvs, Rb^Gvs, Rb^Gvs, Ss, Rb^Gvs, Rb^Gvs, Sm, Wwg, Wwg, Wog, Wog, Wog
Mm, Mm, Mm, Hh, Hh, Hh, Hh, Hh, Gs, Rb, Co, Rb, Rb, Rb, Re, Re, Re^Edt, Gs, Hh, Gs^Fmw, Wwf, Gs, Rb^Gvs, Rb^Gvs, Rb^Gvs, Re, Rb^Gvs, Rb^Gvs, Re^Edt, Rb^Vo, Rb^Gvs, Re^Es, Co, Re^Edt, Re^Vo, Rb^Gvs, Rb^Gvs, Rb^Esa, Rb^Gvs, Rb^Gvs, Rb^Gvs, Sm, Rb^Gvs, Rb^Gvs, Sm, Wwg, Rb^Gvs, Wwr, Wwg, Wwr, Wwg, Wwg, Wog, Wog, Wog, Wog, Wwg
Mm, Mm, Hh, Mm, Hh, Hh, Aa, Gs, Gs, Rb, Co, Co, Re, Re, Re^Edt, Re^Edt, Gs, Gs^Fmw, Hh, Hh, Aa, Aa, Rb^Gvs, Rb^Gvs, Rb^Gvs, Rb^Gvs, Rb^Gvs, Re^Edt, Rb^Gvs, Rb^Gvs, Rb^Gvs, Re, Re, Re, Rb^Gvs, Rb^Gvs, Rb^Gvs, Rb^Gvs, Rb^Gvs, Rb^Gvs, Rb^Gvs, Rb^Gvs, Sm, Rb^Gvs, Ss, Ss, Wwr, Wwg, Wog, Wog, Wog, Wog, Wwg, Wog, Wwg, Wwg, Sm
Gs^Fmw, Hh, Aa, Hh, Aa, Hh, Gd, Gs, Re, Rb, Rb, 1 Ko, Co, Re, Gs, Gs, Hh, Hh, Re^Vo, Gs, Re, Rb^Gvs, Rb^Gvs, Rb^Gvs, Rb^Gvs, Rb^Gvs, Rb^Gvs, Re, Rb^Gvs, Rb^Gvs, Aa^Gvs, Rb^Gvs, Rb^Gvs, Rb^Gvs, Rb^Gvs, Rb^Gvs, Rb^Gvs, Rb^Gvs, Sm, Rb^Gvs, Ss, Rb^Gvs, Rb^Gvs, Sm, Ss, Ss, Wwg, Wog, Wwg, Wog, Ai, Ai, Sm, Wwg, Sm, Sm, Sm
Hh, Hh, Aa, Aa, Aa, Aa, Gd, Gd, Re, Re, Rb, Co, Co, Rb, Gs, Gs, Hh, Hh, Gs, Re, Rb^Gvs, Rb^Gvs, Rb^Gvs, Rb^Gvs, Rb^Gvs, Rb^Gvs, Re, Re, Rb^Gvs, Aa^Gvs, Aa^Gvs, Rb^Esa, Rb^Gvs, Rb^Gvs, Rb^Gvs, Rb^Esa, Rb^Gvs, Wwg, Ss, Ss, Ss, Rb^Gvs, Sm, Sm, Wwg, Ai, Wwg, Wwg, Wwr, Wwr, Sm, Aa^Esa, Sm, Sm, Gll^Fp, Sm, Gll^Fp
Gd, Gd, Gd^Es, Gd^Es, Re, Gd^Es, Re, Re, Re, Re, Rb, Rb, Rb, Rb, Re, Re, Re, Re, Re, Re, Rb^Gvs, Rb^Gvs, Rb^Gvs, Rb^Gvs, Rb^Gvs, Rb^Gvs, Re^Edt, Rb^Gvs, Aa^Gvs, Aa^Gvs, Aa^Gvs, Aa^Gvs, Rb^Gvs, Rb^Gvs, Wwg, Aa^Gvs, Aa^Gvs, Sm, Sm, Ss, Rb^Gvs, Wwg, Wwg, Ss, Wwg, Wwg, Sm, Ss, Sm, Ss, Gll^Fp, Gs, Gll^Fp, Gll^Fp, Gll^Fp, Gll^Fp, Gll^Fp
Re^Edt, Gd^Es, Rb^Edt, Re^Es, Re^Edt, Re^Edt, Re^Edt, Re, Gd, Rb, Gd, Rb, Gd, Gd, Aa, Wwf, Aa, Wwf, Gs, Gs, Rb^Gvs, Rb^Gvs, Rb^Gvs, Rb^Gvs, Rb^Gvs, Re^Vo, Re^Edt, Rb^Esa, Rb^Gvs, Wwf, Rb^Esa, Aa^Gvs, Rb^Gvs, Rb^Gvs, Rb^Esa, Aa^Gvs, Rb^Gvs, Sm, Rb^Gvs, Rb^Gvs, Ss, Wwg, Sm, Wwg, Wwg, Wwr, Ss, Sm, Aa, Gs^Esa, Gs, Gll^Fp, Sm, Ss, Sm, Sm, Gll^Fp
Re^Edt, Rb^Edt, Re^Edt, Re^Edt, Gd^Es, Re, Gd^Es, Gd, Aa, Wwf, Aa, Gd, Gd^Fmw, Hh, Hh, Aa, Aa, Aa, Gs^Fmw, Gs^Fmw, Rb^Fmw, Rb^Gvs, Rb^Gvs, Rb^Gvs, Rb^Gvs, Rb^Gvs, Rb^Gvs, Rb^Gvs, Rb^Gvs, Rb^Gvs, Rb^Gvs, Rb^Gvs, Rb^Gvs, Rb^Gvs, Rb^Gvs, Rb^Gvs, Rb^Gvs, Rb^Esa, Rb^Gvs, Rb^Gvs, Ss, Ss, Ss, Wwg, Wwg, Ss, Ss, Sm, Aa, Sm, Ss, Sm, Sm, Sm, Sm, Sm, Ss
Gs, Gd, Hh, Gd, Gd, Gd^Es, Aa, Aa, Aa, Hh, Hh, Hh, Hh, Hh, Mm, Hh, Hh, Aa^Fmw, Aa^Fmw, Gs^Fmw, Rb^Fmw, Rb^Gvs, Rb^Gvs, Rb^Gvs, Rb^Gvs, Rb^Gvs, Rb^Gvs, Rb^Gvs, Rb^Esa, Rb^Gvs, Aa^Gvs, Rb^Esa, Wwg, Rb^Gvs, Rb^Gvs, Rb^Gvs, Sm, Rb^Gvs, Rb^Gvs, Ss, Ss, Ss, Ai, Wwg, Wwg, Wwg, Ss, Aa, Sm, Ss, Ss, Sm, Aa, Gs^Esa, Gll^Fp, Ss, Gll^Fp
Hh, Hh, Hh, Hh, Hh, Hh, Hh, Hh, Hh, Hh, Hh, Hh, Mm, Mm, Mm, Hh, Gs, Aa^Fmw, Aa^Fmw, Gs^Fmw, Gs^Fmw, Rb^Fmw, Rb^Gvs, Rb^Gvs, Rb^Gvs, Rb^Gvs, Rb^Gvs, Rb^Gvs, Rb^Gvs, Aa^Esa, Aa^Gvs, Wwg, Wwg, Wwg, Rb^Gvs, Rb^Gvs, Rb^Gvs, Rb^Gvs, Ss, Ss, Ss, Ss, Ss, Wwg, Wwg, Ss, Ss, Sm, Sm, Sm, Gs, Aa, Gs, Sm, Gs, Gll^Fp, Gll^Fp
