Gll^Fp, Gll^Fp, Gll^Fmw, Gll^Fms, Gll^Fmw, Gll^Fmw, Gll^Fmw, Gll^Fmw, Gll^Fp, Gll^Fmw, Gll^Fp, Wwg, Gll^Fms, Gll^Fp, Gll^Fp, Gll^Fmw, Hh, Hh, Hh, Mm, Mm, Mm, Ms, Ms, Ms, Mm, Ms, Ms, Ms, Ms, Ms, Mm, Hh, Hh, Hh, Hh, Wo, Wo, Wo, Wo, Wo, Wo, Ww, Ww, Ai, Aa, Gg^Edb, Gg, Gg, Gg, Gg, Gg^Edb, Gg, Ww, Gg, Gg, Gg
Gll^Fmw, Gll^Fmw, Gll^Fp, Gll^Fp, Gll^Fmw, Gll^Fp, Re^Vhr, Gll^Fp, Re^Fp, Gll^Fp, Wwg, Wwg, Gll^Fp, Gll^Fmw, Gll^Fmw, Gll^Fp, Hh, Hh, Hh, Mm, Mm, Mm, Ms, Ms, Ms, Ms, Mm, Mm, Mm, Ms, Mm, Mm, Hh, Hh, Hh, Sm, Sm, Wo, Wo, Wo, Wo^Edt, Wo, Wo, Ww, Ww, Ww, Aa, Gg, Aa, Gg^Edb, Gg^Edb, Aa, Ww, Ww, Gg, Gg, Gg
Gll^Fp, Gll^Fp, Gll^Fp, Gll^Fp, Gll^Fmw, Gll^Fp, Gll^Fms, Re^Fp, Gll^Fmw, Re^Fp, Wwg^Bw\r, Gll^Fp, Gll^Fp, Gll^Fp, Gll^Fp, Gll^Fms, Gll^Fmw, Gll^Fp, Hh, Hh, Mm, Mm, Ha, Ha, Ww, Ha, Mm, Ha, Hh, Mm, Hh^Vhhr, Mm, Hh, Hh, Rb, Sm, Sm, Wo, Sm, Wo, Wo, Wo^Edt, Wo^Edt, Wog, Wog, Ww, Ai, Aa, Aa, Gg^Edb, Gg^Edb, Aa, Ww, Aa, Gg^Edb, Gg, Gs
Hh, Hh, Hh, Gll^Fp, Ha, Gll^Fp, Ha, Aa, Wwg, Wwg, Gll^Fp, Re^Fp, Re^Fp, Re^Fp, Re^Fp, Gll^Fp, Re^Fp, Gll^Fms, Re^Fms, Hh, Mm, Mm, Ha, Ww, Ha, Ha, Ha, Ha, Hh, Hh, Re^Es, Hh, Re, Hh, Rb, Wwg, Sm, Sm, Sm, Sm, Ww, Wo^Edt, Wo^Edt, Wo, Wo, Ww, Ww, Aa, Ww, Ww, Ww, Ww, Gg^Edb, Gg^Edb, Chr^Edb, Gs^Edb, Gs
Hh, Hh, Mm, Ha, Ha, Ha, Ha, Wwg, Aa, Aa, Hh, Gll^Fp, Gll^Fp, Gll^Fp, Gll^Fp, Re^Vhr, Gll^Fp, Re^Fms, Gll^Fp, Hh, Hh, Hh, Aa, Ww, Ww, Aa, Hh, Hh, Re, Hh, Re^Es, Re^Es, Rb, Rb, Wwg, Wwg, Wwg, Wwg, Wwg, Sm, Ww, Wo^Edt, Wo, Wo, Wo^Edt, Wo, Wo, Ww, Ww, Ai, Aa, Aa, Gg^Edb, Chr, Chr, Gs, Re
Mm, Mm, Ms, Mm, Ms, Mm, Ms, Wwg, Mm, Hh, Hh, Gll^Fp, Hh, Gll^Fp, Gll^Fp, Gll^Fms, Gll^Fms, Gll^Fmw, Hh, Hh, Hh, Hh, Hh, Aa, Ww, Aa, Re, Re^Es, Aa, Re, Re, Re, Rb, Wwg, Wwg^Edt, Co, Co, Wwg, Co, Wwg, Wwg^Edt, Ww^Edt, Wo, Wo, Co, Wo^Edt, Wo, Wo, Ww, Ww, Ai, Gg^Edb, Aa^Edb, Gg^Edb, Re^Edb, Re, Chr
Ms, Ms, Ms, Ms, Ms, Ms, Mm, Mm, Mm, Mm, Hh, Hh, Hh, Hh, Hh, Gll^Fms, Gll^Fp, Gll^Fp, Gll^Fms, Hh, Hh, Hh, Gll^Fp, Aa, Ww, Ww, Re, Aa, Aa, Hh, Hh, Rb, Wwg, Wwg^Edt, Wwg^Edt, Co, Rb^Edt, Co, Rb^Es, Wwg, Sm^Dr, Co^Qhu, Co, Co^Es, Co^Es, Wo, Wo^Edt, Wo, Wo, Ww, Ww, Ww^Edb, Aa, Gg, Re, Chr^Edb, Chr
Ha, Ha, Ms, Ms, Ha, Mm, Ha, Hh^Vhhr, Hh, Mm, Hh, Hh, Hh, Gll^Fp, Gll^Fms, Gll^Fp, Gll^Fms, Gll^Fms, Gll^Fms, Gll^Fp, Gll^Fp, Gll^Fmw, Gll^Fmw, Gll^Fp, Aa, Ww, Wwg^Bw|r, Wwg, Wwg, Hh, Sm, Sm, Sm^Edt, Wwg^Edt, Wwg^Edt, Wwg^Edt, Sm^Edt, Rb^Edt, Rb^Edt, Re^Vo, Rb, Sm^Dr, Sm^Dr, Sm^Edt, Ww^Edt, Wo^Edt, Wo, Wo^Edt, Wo, Wo, Ww, Ww, Ww^Bw/r, Re, Gg^Edb, Gg^Edb, Gg^Edb
Ha, Ha, Ha, Ms, Ha, Ha, Hh, Hh, Hh, Hh, Hh, Gll^Fms, Gll^Fp, Gll^Fp, Gs^Fp, Gs^Fp, Gll^Fmw, Gll^Fp, Gll^Fp, Gll^Fp, Gll^Fp, Gll^Fp, Gll^Fmw, Gll^Fp, Aa, Aa, Re, Aa, Wwg, Sm, Sm, Sm, Wwg^Edt, Wwg^Edt, Co^Dr, Sm^Edt, Re^Vo, Rb^Edt, Re^Edt, Re, Re, Sm^Dr, Re^Vo, Sm^Edt, Co, Wo, Wo, Wo^Edt, Wo, Wo, Wo, Ww, Ww, Ai, Ww, Aa, Gg
Wwg, Ha, Wwg, Ha, Aa, Ha, Hh, Gll^Fmw, Gll^Fp, Hh, Gll^Fmw, Gll^Fp, Gll^Fp, Gll^Fp, Gll^Fp, Gll^Fp, Gll^Fp, Gll^Fmw, Gll^Fp, Gll^Fmw, Rb^Edt, Gll^Fms, Rb^Edt, Rb^Edt, Rb, Re, Cer, Re, Aa, Wwg, Sm, Wwg^Edt, Co, Co^Dr, Rb^Dr, Rb^Dr, Rb^Es, Re^Edt, Ko, Ko, Ko, Re, Rb^Edt, Sm, Rb^Edt, Co, Ww, Wo, Co, Wo^Bw/r, Wo, Wo, Ww, Ww, Ww, Ai, Ai
Wwg, Wwg, Wwg, Aa, Aa, Hh, Gll^Fmw, Gll^Fp, Gll^Fp, Gll^Fmw, Gll^Fms, Gll^Fp, Gll^Fmw, Gll^Fmw, Gll^Fms, Gll^Fms, Rb^Edt, Gll^Fmw, 5 Rb^Edt, Gll^Fms, Rb^Edt, Rb^Edt, Rb^Edt, Rb, Rb, Re, Re, Re^Edt, Sm, Sm, Wwg, Sm^Edt, Sm^Edt, Co^Es, Sm^Edt, Rb^Dr, Rb, Re, Ko, 4 Ko, Ko, Re^Edt, Rb^Edt, Rb^Edt, Rb, Co^Es, Co, Ww^Bw/r, Ww, Wo, Wo, Wo^Edt, Wo, Ww, Ww, Ai, Ai
Wo, Wo, Wwg, Wwg, Hh, Hh, Gll^Fp, Gll^Fms, Rb^Edt, Rb^Edt, Rb^Edt, Rb^Edt, Rb^Edt, Rb^Edt, Rb^Edt, Gll^Fms, Rb^Edt, Rb^Edt, Rb^Edt, Rb^Edt, Rb^Edt, Rb^Edt, Hhd, Rb, Hhd, Hhd, Re, Aa, Aa, Aa, Sm, Sm, Sm^Es, Sm^Edt, Sm^Dr, Rb^Edt, Re^Vo, Re, Re, Ko, Re, Re, Re^Vo, Wwg^Edt, Wwg^Edt, Co, Wwg, Ww, Ww, Wo, Ww, Wo^Edt, Wo^Edt, Wo, Ww, Ww, Ai
Wo, Wo, Wwg, Aa, Mm, Hh, Gll^Fp, Gll^Fmw, Rb^Edt, Rb^Edt, Rb^Edt, Rb^Edt, Gll^Fp, Rb^Edt, Rb^Edt, Rb^Edt, Rb^Edt, Rb^Edt, Rb^Edt, Rb^Edt, Aa, Hhd, Re^Es, Hhd, Hhd, Re, Gs^Edt, Gg^Vo, Hh, Aa, Wwg, Sm, Wwg, Sm^Edt, Co, Rb, Rb^Edt, Rb, Re, Kte^Feth, Re, Rb, Rb^Dr, Rb^Dr, Sm^Dr, Wwg^Edt, Rb, Rb, Rb^Vo, Rb, Sm, Wo, Wo, Wo^Edt, Wo, Ww, Ww
Wo, Wo, Ha, Mm, Mm, Hh, Hh, Rb, Rb, Rb, Aa, Gll^Fp, Gll^Fp, Gll^Fp, Aa, Rb^Edt, Rb, Rb^Edt, Rb, Rb, Rb, Re^Es, Re^Es, Cer, Re, Re, Gs, Gg^Edt, Hh, Hh, Aa, Wwg^Edt, Wwg^Edt, Wwg, Wwg, Re^Eqp, Re^Pw\, Re, Re, Re^Edt, Rb^Vo, Rb^Es, Rb^Dr, Rb^Dr, Sm^Edt, Sm^Edt, Sm, Sm, Sm, Rb^Edt, Ww, Wo, Wo, Wo^Edt, Wo, Wo, Wo
Wo, Wwg, Ha, Hh, Hh, Hh, Gll^Fms, Rb, Re, Re, Gll^Fms, Gll^Fms, Gll^Fp, Aa, Aa, Aa, Re, Rb, Rb, Rb, Rb, Re^Es, Re, Re, Gs, Gg, Gg^Vo, Gg, Gg, Aa, Aa, Wwg^Edt, Sm^Edt, Wwg, Rb, Rb, Re, Re^Pw\, Re^Pw\, Rb^Edt, Co, Co, Co^Es, Co^Es, Sm^Edt, Sm^Edt, Wwg, Rb^Vo, Rb^Edt, Rb, Sm, Ww, Wo, Wo, Wo, Wo, Wo
Wwg, Wwg, Wwg, Aa, Aa, Hh, Hh, Gll^Fms, Re, Re, Re, Gll^Fmw, Re, Re, Re, Re, Re, Rb, Cer, Cer, Co, Rb, Re, Gs, Gs, Hh, Hh, Gg^Edt, Hh, Gs, Gs, Sm, Sm^Edt, Sm^Edt, Sm^Bw/r, Re, Rb, Rb, Sm^Edt, Re^Eqp, Sm^Edt, Sm^Edt, Sm^Edt, Co, Wwg, Sm^Edt, Wwg, Rb^Edt, Re, Re, Rb, Ww, Ww, Wo, Ww, Wo, Wo
Ha, Aa, Wwg, Aa, Aa, Hh, Gll^Fp, Gll^Fms, Re, Re, Re, Re, Gs, Re, Cer, Re^Es, Hhd, Hhd, Co, 3 Ko, Cer, Rb, Re, Re, Aa, Aa, Hh, Hh, Hh, Gs, Hh, Wwg, Rb, Sm^Bw/r, Wwg^Bw/r, Sm^Bw/r, Wwg, Sm^Edt, Sm^Edt, Wwg, Wwg, Wwg, Rb, Sm^Edt, Rb, Wwg, Rb, Sm, Re, Rb, Sm, Sm, Sm, Ww, Ww, Wo, Wo
Ha, Ha, Ha, Wwg, Aa, Aa, Gll^Fp, Re, Re, Cer, Re, Aa, Gs, Re, Re^Es, Re^Es, Hhd, Hhd, Hhd, Cer, Hhd, Re^Es, Re, Gs, Wwg, Hh, Aa, Hh, Hh^Vo, Hh, Aa, Wwg, Rb, Rb, Rb, Wwg, Rb, Sm^Edt, Rb, Rb, Rb, Sm^Edt, Rb, Rb, Rb, Rb^Edt, Rb^Edt, Sm, Sm^Bw|r, Sm, Rb^Gvs, Sm, Sm, Sm, Ww, Wo, Wo
Mm, Mm, Hh, Hh, Gll^Fp, Gd^Fms, Gll^Fp, Re, Gs, Re, Aa, Aa, Gg^Vo, Gs, Hh, Hhd, Hh, Hhd, Aa, Hhd, Aa, Gs, Wwg, Re, Wwg, Aa, Aa, Hh, Hh, Hh, Wwg, Rb, Re, Re^Es, Re, Rb, Rb, Rb^Vo, Re, Rb, Rb, Sm^Edt, Sm, Rb, Aa, Rb^Vc, Rb^Edt, Rb^Gvs, Rb^Gvs, Rb^Gvs, Aa, Rb^Gvs, Rb^Gvs, Sm, Ww, Wo, Wo
Hh, Hh, Hh, Gll^Fp, Gd^Fmw, Gll^Fp, Gd^Fmw, Re, Gs, Gs, Gg, Gg^Edt, Aa, Gg, Hh, Hh, Gg, Hh, Aa, Aa, Aa, Wwg, Gs, Re, Rb, Wwg, Aa, Aa, Aa, Aa, Rb, Rb, Re^Es, Re^Es, Rb, Rb, Sm, Rb, Cer, Re, Sm^Bw\r, Sm, Rb^Gvs, Rb^Gvs, Rb^Gvs, Rb^Gvs, Rb^Gvs, Rb^Gvs, Rb^Gvs, Rb^Gvs, Aa, Aa, Rb^Gvs, Rb, Rb, Ww, Wo
Gll^Fmw, Gll^Fmw, Gll^Fp, Gll^Fp, Re, Re, Re, Re, Gg, Gg, Hh, Aa, Aa, Wwg, Wwg, Gg, Aa, Wwg, Gg, Gg, Gg, Gg, Gs, Re, Re, Rb, Re, Re, Re, Re, Re, Re, Hhd, Hhd, Rb, Sm, Rb^Gvs, Rb^Gvs, Rb^Gvs, Rb^Gvs, Rb^Gvs, Re, Re, Rb^Gvs, Aa, Aa, Aa, Rb^Gvs, Rb, Rb^Gvs, Rb^Gvs, Rb^Gvs, Rb^Gvs, Rb, Sm, Ww, Ww
Gll^Fp, Gll^Fms, Gll^Fms, Gd, Gg^Vo, Gg, Gg, Hh, Hh, Hh, Hh, Aa, Wwg, Aa, Gg, Gg, Aa, Aa, Aa, Gg, Gs, Gs^Vo, Re^Edt, Re, Re, Re, Re^Es, Re, Re, Re, Re, Aa, Aa, Aa, Sm, Sm, Rb^Gvs, Rb^Gvs, Rb^Gvs, Rb^Gvs, Rb, Rb^Gvs, Re, Rb^Gvs, Rb^Gvs, Wwg, Sm, Sm, Rb^Gvs, Rb^Gvs, Rb, Rb^Gvs, Rb^Gvs, Sm, Sm, Ww, Ww
Re, Re, Re, Re, Gg^Edt, Gg^Edt, Hh, Hh, Hh, Hh, Hh, Hh, Gg^Edt, Gg, Gs, Gg, Wwg, Wwg, Aa, Gg, Rb, Re^Edt, Re, Re, Hhd, Re^Es, Re, Re, Re, Re^Vo, Hhd, Re, Cer, Rb, Rb^Gvs, Rb^Gvs, Rb^Gvs, Aa, Aa, Sm, Sm, Rb^Gvs, Rb^Gvs, Re, Aa, Aa, Aa, Rb, Rb^Gvs, Rb^Gvs, Sm, Rb^Gvs, Rb^Vc, Rb, Aa, Ww, Ww
Wwg, Gg, Gg, Gg, Gg, Gg^Edt, Hh, Hh, Hh, Hh, Hh, Gs, Gg, Gg^Vo, Gs, Gg, Gg, Wwg, Aa, Aa, Rb, Re, Re^Es, Hhd, Rb^Gvs, Hhd, Rb^Gvs, Rb^Gvs, Rb, Re^Es, Hhd, Re, Rb, Rb^Gvs, Rb^Gvs, Rb^Gvs, Rb, Wwg, Aa, Sm, Sm, Rb, Rb^Gvs, Re, Re, Aa, Rb^Gvs, Rb^Gvs, Rb^Gvs, Rb, Sm, Rb^Gvs, Rb, Rb^Edt, Aa, Ww, Wo
Wwg, Wwg, Aa, Gg, Gg, Gs, Gs, Gg, Gg, Gg, Gg, Gg, Aa, Gs, Hh, Hh, Gg, Gg, Gs, Rb, Re, Re, Re^Es, Rb, Rb^Gvs, Rb^Gvs, Aa, Aa, Re, Re, Cer, Hhd, Re, Rb^Gvs, Rb^Gvs, Rb^Gvs, Rb^Gvs, Aa, Rb^Gvs, Aa, Rb, Rb^Gvs, Rb^Gvs, Rb^Gvs, Re, Rb^Gvs, Rb^Gvs, Rb^Gvs, Rb^Gvs, Rb^Gvs, Rb, Sm, Sm, Aa, Ww, Ww, Wo
Aa, Aa, Wwg, Wwg, Wwg, Gs, Gs, Gs, Gs, Aa, Aa, Aa, Aa, Wwg, Gs, Hh, Gg, Gs, Re, Re, Re, Re, Rb, Rb^Gvs, Rb^Gvs, Aa, Rb^Gvs, Aa, Aa, Co, 2 Ko, Cer, Hhd, Re, Re, Re^Vc, Re^Edt, Rb^Gvs, Rb^Gvs, Rb^Gvs, Rb^Gvs, Rb^Gvs, Re^Edt, Re^Vc, Rb^Gvs, Re, Re, Re, Re, Re, Sm, Sm, Wo, Wo, Wo, Wo, Wo
Aa, Aa, Aa, Aa, Aa, Gs, Rb, Gs, Gs, Wwg, Gg, Gg, Gg, Gs, Gs, Gs, Gs, Re, Re, Re^Edt, Re, Re, Rb^Gvs, Rb^Gvs, Rb^Gvs, Rb^Gvs, Rb^Gvs, Re, Hhd, Cer, Cer, Co, Re, Rb, Rb^Gvs, Rb^Edt, Rb, Re^Edt, Re, Re, Re, Re, Rb^Gvs, Rb^Gvs, Rb^Gvs, Rb^Gvs, Rb, Sm, Sm, Sm, Sm, Sm, Wo, Wo, Wo, Wo, Ww
Aa, Hh, Hh, Hh, Hh, Hh, Hh, Hh, Gs, Gg, Gs, Gs, Gs, Gs, Gs, Gs, Re, Re, Re^Edt, Re^Edt, Rb, Rb^Gvs, Rb^Gvs, Rb^Gvs, Rb^Gvs, Rb^Gvs, Rb^Gvs, Cer, Hhd, Hhd, Re, Re, Rb^Gvs, Rb^Gvs, Rb^Gvs, Rb^Gvs, Rb^Gvs, Rb^Gvs, Rb^Gvs, Rb, Rb, Rb^Gvs, Rb^Gvs, Rb^Gvs, Rb^Gvs, Rb^Gvs, Aa, Ww, Wo, Wo, Wo, Wo, Wo, Wo, Ww, Ww, Ai
Hh, Hh, Hh, Hh, Hh, Hh, Hh, Hh, Hh, Gg, Gs, Co, Co, Rb, Rb, Re, Re, Re, Re^Edt, Re^Edt, Gs, Rb, Rb^Gvs, Rb^Gvs, Rb^Gvs, Rb^Gvs, Rb^Gvs, Rb^Gvs, Re^Edt, Re, Rb^Gvs, Rb^Gvs, Aa, Rb^Gvs, Aa, Rb^Gvs, Rb^Gvs, Rb^Gvs, Rb^Gvs, Rb^Gvs, Rb, Sm, Aa, Rb^Gvs, Rb^Gvs, Aa, Aa, Wo, Wo, Wo, Wo, Wo, Ai, Ww, Ww, Ai, Ai
Hh, Hh, Hh, Hh, Hh, Hh, Hh, Hh, Gg^Es, Gg, Rb, Cer^Vct, 1 Ke, Co, Co, Rb, Re, Re, Gs, Gs, Gs, Gs, Rb^Gvs, Rb^Gvs, Rb^Gvs, Rb^Gvs, Rb^Gvs, Re^Vc, Rb^Gvs, Rb^Gvs, Rb^Gvs, Rb^Gvs, Aa, Aa, Aa, Rb, Rb^Gvs, Rb^Gvs, Rb^Gvs, Rb^Gvs, Rb^Gvs, Sm, Sm, Rb, Rb^Gvs, Aa, Wo, Wo, Wo, Wo, Ww, Ww, Aa, Ai, Gll^Fp, Ww, Ai
Hh, Hh, Hh, Hh, Hh, Gg^Es, Gg^Es, Hh, Gg, Gs, Rb, Cer^Vct, Cer^Vct, Cer^Vct, Rb^Edt, Rb^Edt, Gs, Gs, Aa, Gg, Aa, Gg, Gg, Rb^Gvs, Rb^Gvs, Rb^Gvs, Rb^Gvs, Rb^Gvs, Rb^Gvs, Rb^Gvs, Rb^Gvs, Aa, Aa, Wwg, Rb^Gvs, Aa, Rb^Gvs, Rb^Gvs, Rb^Gvs, Rb^Gvs, Aa, Ww, Sm, Sm, Ww, Ww, Wo, Wo, Wo, Ww, Ww, Ai, Aa, Gs, Gll^Fp, Gs, Gll^Fp
Hh, Hh, Hh, Hh, Hh, Gg^Es, Gg, Gg, Rb, Re, Rb^Edt, Rb^Edt, Rb^Edt, Rb^Edt, Re, Gs^Edt, Aa, Aa, Aa, Gg, Ww, Aa, Aa, Rb, Rb^Gvs, Cer, Rb^Gvs, Rb^Gvs, Rb^Gvs, Rb^Gvs, Rb^Gvs, Rb^Gvs, Rb^Gvs, Rb^Gvs, Rb, Rb^Gvs, Rb, Rb^Gvs, Rb^Gvs, Rb^Gvs, Rb, Aa, Rb, Ww, Ww, Wo, Wo, Wo, Ww, Ww, Ai, Ai, Gs^Fms, Gs, Gll^Fp, Gll^Fp, Gs^Fms
Hh, Hh, Hh, Gg^Es, Gg, Gg, Gg, Gg, Re, Re, Rb^Edt, Rb^Edt, Re, Re, Gs, Gs, Aa, Aa, Aa, Aa, Ww, Aa, Ai, Rb, Rb, Rb^Gvs, Rb^Gvs, Rb^Gvs, Rb^Gvs, Rb^Gvs, Rb^Gvs, Rb^Gvs, Rb^Gvs, Rb^Gvs, Rb, Sm, Sm, Rb^Gvs, Rb^Gvs, Rb^Gvs, Rb^Gvs, Rb^Gvs, Aa, Ww, Wo, Wo, Wo, Wo, Ww, Ww, Gs, Gs, Gs^Fms, Gs^Fms, Gs^Fms, Gll^Fp, Gs^Fms
Gg, Gg^Es, Gg, Gg^Es, Gg, Gg, Gg, Gs, Re, Rb^Edt, Rb, Re, Gs, Gs, Gg, Aa, Aa, Ai, Wo, Ai, Wo, Ww, Ai, Ai, Ww, Ww, Ww, Rb, Rb, Rb, Aa, Rb^Gvs, Aa, Rb, Sm, Sm, Sm, Rb, Rb^Gvs, Aa, Aa, Aa, Ai, Wo, Wo, Wo, Ww, Ww, Ai, Gs^Fms, Gll^Fp, Gs, Gs, Gs^Fms, Gll^Fp, Gs^Fms, Gs^Fms
Gg, Gg, Gg, Gg, Gg, Gg, Gg, Re, Re, Rb^Edt, Re, Re, Gg, Gg, Aa, Aa, Wwg, Wo, Wo, Wo, Wo, Wo, Wo, Wo, Wo, Wo, Ww, Ww, Ww, Aa, Aa, Aa, Wwg, Wwg, Sm, Sm, Sm, Sm, Sm, Wwg, Wwg, Aa, Sm, Wo, Wo, Ww, Ww, Ww, Sm, Gs^Fms, Gs^Fms, Gs, Gs^Fms, Gll^Fp, Gll^Fp, Gll^Fp, Gs^Fms
