Hhd, Hhd, Mm, Hhd, Mm^Xm, Mm^Xm, Mm^Xm, Mm, Hhd, Hhd, Hhd, Hhd, Hhd, Gd, Re, Gd, Hhd, Hhd, Hhd, Hhd, Mm, Mm, Mm^Xm, Mm^Xm, Mm^Xm, Mm^Xm, Mm^Xm, Mm, Mm, Mm, Mm, Hhd, Hhd, Gs, Gs, Gs, Gs, Gs, Gd, Gs, Gd^Fp, Gd, Hhd, Hhd, Hhd, Hhd, Hhd, Hhd, Hhd, Gd, Gd^Fp, Gs, Gs, Gs, Gd^Fp, Gd, Hhd, Gd, Hhd, Gd^Fp, Gd^Fp, Gs, Gs, Gs, Gs, Gs, Gs, Gs, Gs
Hhd, Hhd, Hhd, Mm, Mm, Mm^Xm, Mm, Mm, Hhd^Fdw, Hhd, Hhd, Gd, Gd, Gd, Gd^Es, Re, Gd, Hhd, Hhd, Hhd, Mm, Mm, Mm, Mm, Mm, Mm^Xm, Mm^Xm, Mm^Xm, Mm^Xm, Mm, Mm, Mm, Hhd^Fp, Gd^Fp, Hhd, Gs, Gd^Fp, Rd, Rd^Cov, Rd^Cov, Rd^Cov, Rd, Gd^Fp, Hhd^Fp, Hhd^Fp, Hhd, Hhd, Hhd, Hhd^Fp, Hhd^Fp, Gd^Fp, Gd^Fp, Gd, Gs, Gd, Gd^Fp, Hhd, Hhd, Hhd, Gd^Fp, Gd, Gd, Gd, Gd^Es, Gd, Gs, Gs, Gs, Gs
Hhd, Hhd, Hhd, Hhd, Hhd, Mm, Mm, Mm, Hhd^Fdw, Hhd, Hhd, Gd, Gd, Gd, Re^Es, Re, Hhd, Hhd, Hhd, Hhd, Hhd^Fdw, Hhd, Mm, Mm, Hhd, Mm, Mm, Mm^Xm, Mm^Xm, Mm^Xm, Mm, Mm, Mm, Mm, Mm, Hhd^Fp, Gd^Fp, Gd^Es, Rd^Cov, 3 Rd^Kov, Rd^Cov, Gd^Es, Gd, Hhd, Gd, Gd^Fp, Gd, Gd^Vo, Gd, Hhd, Gs, Gd^Es, Gs, Gd, Gd, Gd^Es, Gd^Fp, Hhd^Fp, Gs, Gs, Gd^Es, Rd^Es, Rd^Dr, Rd, Gd, Gs, Gs, Gs, Gs
Gd, Gd, Hhd, Hhd, Hhd, Mm, Mm, Mm, Mm, Gd^Fdw, Gd, Gd, Gs^Vo, 4 Gd, Re, Gd, Gs, Hhd^Fdw, Gd^Fdw, Hhd^Fdw, Hhd^Fdw, Hhd, Mm, Mm, Hhd, Hhd, Hhd, Mm, Mm^Xm, Mm, Mm, Mm, Mm, Mm, Mm, Mm, Mm, Hhd, Gs, Rd^Cov, Gs^Es, Rd^Es, Gd, Gd, Gs, Gs, Gd, Rd, Rd, Gs, Gs, Gd, Hhd, Gd^Fp, Hhd, Gd, Gs, Gd^Fp, Hhd, Gs, Rd, Rd^Es, Rd^Es, Rd, Rd, Gd, Gd^Es, Gs, Gs
Re, Gd, Gd^Es, Gd, Hhd, Hhd^Fdw, Hhd, Mm, Gs, Gd^Es, Hhd, Gs, Gll, Gll, Gll, Gd^Es, Gd, Gd, Gd, Gd^Fdw, Hhd, Hhd^Fdw, Hhd, Hhd, Hhd^Fdw, Hhd, Hhd^Fdw, Hhd^Fdw, Mm, Mm, Mm, Mm, Hhd, Mm, Mm, Mm, Mm, Mm, Mm, Hhd, Hhd, Hhd, Hhd, Gd^Fp, Hhd, Hhd, Gs^Es, Rd^Es, Rd^Dr, Rd^Es, Gs, Hhd, Gd^Fp, Hhd^Fp, Hhd, Gd, Gd, Gs^Vo, Gd, Gs, Gd, Gd^Es, Gd^Es, Gs, Gd^Fp, Gs, Gd^Es, Gs^Es, Gs
Re, Re, Re, Gd, Gd^Vo, Hhd, Gd^Fdw, Gd, Gs, Gd^Es, Hhd, Gd^Es, Hhd, Gll, Gd, Re, Hhd, Hhd, Hhd, Gd, Gd, Hhd, Rd^Es, Hhd, Gd, Gd^Fdw, Gd^Fdw, Hhd, Hhd, Mm, Mm, Wwg, Wwg, Hhd, Hhd, Mm, Mm, Mm, Mm, Mm, Mm^Fp, Hhd^Fp, Mm, Hhd, Mm, Hhd^Fp, Gd^Fp, Rd, Rd, Rd^Es, Rd, Gd^Fp, Gd^Fp, Hhd, Gd, Hhd, Gd, Gd, Gd^Es, Gd^Es, Rd, Gd, Rd, Gd, Gd^Fp, Gd^Fp, Gd, Gd, Gs
Gd, Gd, Re, Gd, Gd, Hhd, Hhd, Gd, Gd^Es, Hhd, Hhd, Hhd, Hhd, Hhd, Gd^Vo, Re, Hhd, Hhd^Fdw, Hhd, Hhd, Gd, Rd, Rd^Dr, Rd^Es, Hhd, Gd^Fdw, Gd, Gd^Fdw, Hhd, Mm, Hhd, Hhd, Hhd, Wwg, Hhd, Mm, Mm, Mm, Mm, Mm, Mm, Mm, Mm, Mm, Mm, Mm, Mm, Mm, Hhd, Gs^Es, Gs, Gd, Gd, Rd, Rd, Gs, Gs, Gs, Gd^Es, Rd^Es, Rd^Dr, Rd, Gd, Gd, Gs, Gd, Gd, Gd, Gs
Gs, Gd^Es, Gd, Re, Re, Gd, Gd, Gd, Hhd, Hhd, Mm, Mm, Mm, Hhd, Hhd, Re, Re^Es, Gd, Gs, Hhd, Gd, Rd, Gd^Es, Gd^Es, Gd, Hhd, Gd, Gd^Vo, Gd, Hhd, Gd, Hhd, Wwg, Wwg, Gs, Hhd, Mm, Mm, Hhd, Mm, Mm, Mm, Hhd, Mm, Hhd, Hhd, Hhd, Hhd, Hhd, Gd^Fp, Gs, Gd^Es, Gd^Es, Rd, Rd^Dr, Rd^Es, Rd^Es, Gs, Gd, Rd, Rd, Rd, Gd, Gd, Rd^Es, Rd, Rd, Gs, Gs
Gs, Gs, Gs, Gd, Re, Gd, Gd, Hhd, Rd, Hhd, Hhd^Fdw, Mm, Mm, Hhd^Fmw, Gd, Gd^Es, Re, Gd, Re, Gd, Re, Gd^Vo, Re, Re, Re, Gd, Re, Gd^Esd, Gd, Gd, Cer, Wwg, Gd, Gs^Es, Gs^Es, Hhd, Gd, Hhd, Hhd, Hhd, Hhd, Hhd, Hhd^Vo, Hhd, Hhd, Re, Rd, Rd^Dr, Rd, Rd, Gd, Gd, Gs, Rd, Rd, Rd^Es, Gs^Es, Gs, Gd, Gd, Gd^Fp, Gs, Gd, Gd^Es, Rd^Es, Rd^Dr, Rd, Gs, Gs
Gs, Gs, Gd, Gd^Vo, Gd, Re, Gd^Es, Rd^Dr, Rd, Hhd, Hhd, Hhd^Fdw, Mm, Hhd, Gd, Gd^Es, Re^Es, Re, Gd, Re, Gd, Re, Rd, Gd^Esd, Gd, Re, Gd, Re, Re, Re, Re, Wwg, Gd, Gs^Es, Re, Gd^Vo, Gd, Gd, Gll, Re, Co^Dr, Re^Es, Re, Hhd, Co^Dr, Co^Es, Cer, Rd, Rb, Rb, Rb, Gs, Gs, Rd, Gs^Es, Rd, Gs, Gs, Gd, Gs, Gs, Gs, Gs, Gd, Gd, Rd, Gd, Gd, Gs
Gd^Es, Gs^Es, Rd^Es, Rd, Gd^Es, Re, Re, Rd, Gd^Es, Gd^Vo, Gd, Gd^Fmw, Mm, Mm, Mm, Re, Gd, Gs, Gs, Gd, Gd, Rd, Rd^Dr, Rd, Gd, Gd, Gd^Vo, Gd, Gd, Gd, Cer, Wwg^Bp\, Re, Re, Gs^Es, Re, Re, Re, Re, Re^Es, Re, Re^Edt, Re^Edt, Co^Es, Co^Dr, Cer, Re^Edt, Re^Edt, Rb, Sm, Sm, Rb, Gd, Gs, Gs, Gs, Gd, Gd, Gd, Gd, Gd, Gd, Gd, Gs^Vo, Gs, Gd, Gs, Gs, Gs
Gd^Es, Gd^Es, Rd, Rd^Dr, Rd^Es, Gd, Gd, Re, Re, Re, Re^Es, Re^Es, Re, Mm, Re, Re, Gd, Gs, Cer, Gd^Fdw, Hhd, Rd, Hhd, Rd, Hhd, Gd, Gd, Gd^Fdw, Gd, Gd^Fdw, Gd^Fdw, Wwg, Wwg, Gd^Es, Gs^Es, Gs^Es, Gd, Gd, Gll, Re^Es, Gll^Edt, Gll^Edt, Re, Ko, Re, Re^Edt, Gll^Vo, Gll, Hhd, Rb, Ss, Rb, Rb, Gd, Gd^Es, Gd^Es, Gs, Gs, Gd, Rd, Rd^Es, Rd, Rd^Es, Gd, Gs, Gs, Gs, Gs, Gs
Gd, Gd, Rd, Rd^Es, Rd^Es, Gd^Es, Gd, Gd, Gs, Gs, Gd, Gd^Es, Re, Re, Gs, Gs, Gd, Gd^Fdw, Ker, Cer, Mm, Mm, Mm^Xm, Hhd, Hhd, Gd^Fdw, Gd, Gd, Gd, Gd^Fdw, Wwf, Wwf, Gd, Wwg, Wwg, Gd, Rb, Gd, Re, Hhd, Re, Gll^Vo, Gll^Edt, Re, Gll, Re, Re^Edt, Re^Edt, Cer^Es, Rb, Sm, Rb, Sm, Gs^Vo, Gs^Es, Gs^Es, Hhd, Gd^Fp, Hhd, Gs, Rd, Rd^Dr, Rd^Es, Gd^Es, Gs, Gs, Gs, Gs, Gs
Gd, Gd, Gd, Gd, Gd^Es, Gd, Gd, Gd, Gd^Vo, Gd, Gd, Re, Gd, Gd, Gd, Gs, Hhd, Hhd, Hhd, Hhd^Fdw, Mm, Mm, Mm, Mm^Xm, Mm^Xm, Hhd, Hhd, Hhd, Hhd, Gd^Fdw, Wwf, Gd, Gs, Gd, Wwg, Gd, Rb, Rb, Sm, Co^Dr, Hhd, Gll, Gll^Edt, Gll^Vo, Gll, Gll^Edt, Re, Re, Rb, Ss, Rb, Rb, Sm, Gs^Es, Gs, Gs, Hhd, Hhd^Fp, Gd^Fp, Gs, Gs, Rd, Rd, Gs^Es, Gd, Gs, Gs, Gs, Gs
Hhd, Gd, Gd, Gs, Gs, Gs, Gd, Hhd, Hhd, Hhd, Gd, Re, Re, Gd, Hhd, Gd^Fmw, Hhd, Hhd^Fdw, Hhd, Gd^Fmw, Gd^Fmw, Hhd^Fdw, Hhd, Mm, Mm, Mm, Mm, Hhd, Hhd, Wwf, Gd, Gs, Gs, Gd^Es, Gd^Es, Wwg^Bp/, Wwg, Wwg, Wwg, Sm, Ss, Rb, Hhd, Rb, Rb, Gll^Vo, Hhd, Co^Dr, Sm, Ss^Bp\, Rb, Re, Re, Gs, Re, Gs, Rd, Hhd, Rd, Rd, Hhd, Hhd, Gd^Fp, Gd, Gd, Gs, Gs, Gs, Gs
Hhd, Hhd, Gd^Vo, Gs, Gs, Gs, Gd, Gd^Fmw, Hhd^Fdw, Hhd^Fmw, Hhd, Hhd, Re, Hhd, Gd^Vo, Hhd, Gd, Gd, Gd, Gd^Fmw, Gd^Fmw, Hhd^Fmw, Gd^Fmw, Hhd^Fmw, Hhd^Fdw, Mm, Hhd, Hhd, Hhd, Hhd, Hhd, Gs^Es, Rd, Rd^Es, Gs^Es, Gd, Rb, Rb, Rb, Wo, Wo, Sm, Sm, Cer^Es, Sm, Rb, Sm, Ss, Wo, Wwg, Wwg, Sm, Gd, Re, Gd, Re, Rd^Es, Rd^Dr, Rd, Gd^Vo, Gd, Hhd, Gs, Gs, Gd, Gs, Gs, Gs^Cov, Gs
Hhd, Hhd, Gd^Fmw, Gd, Gs, Gs, Gd, Hhd, Gd^Es, Hhd, Gd^Es, Gd, Re, Gd, Gd, Gd^Es, Rd^Es, Gd, Gs, Gd, Gs, Gd, Gd, Gd, Gd^Fmw, Hhd, Gd^Vo, Hhd, Hhd, Hhd, Gd^Es, Gs^Es, Rd^Dr, Rd, Gs^Vo, Gs, Gd, Gd, Gd, Rb, Wwf, Wwg, Rb, Sm, Rb, Sm, Rb, Wwg, Rb, Wwg, Wwg, Sm, Gd^Es, Gd, Hhd, Rd, Gs^Es, Rd^Es, Gs, Re, Re, 1 Re, Re, Gs, Re, Gs, Re^Cov, Gs^Cov, Re
Hhd, Hhd, Gd, Gd, Gd, Gs, Gd, Gd, Gd^Es, Gd^Es, Gd^Es, Gd, Gd, Re, Re, Rd, Rd^Dr, Rd^Es, Gs^Es, Gs, Gs, Gd, Gd, Gs, Gs, Gs, Gs^Es, Gd, Hhd, Hhd, Gd, Gd^Es, Rd, Rd, Gs, Gs, Hhd, Gd, Hhd^Fp, Gd, Wwf, Rb, Gd, Rb, Gd, Rb, Gd, Rb, Rd^Es, Rb, Gd, Wwg, Gd, Gd^Fp, Hhd, Hhd, Hhd^Fp, Gs, Gs, Gs, Gs, Re, Gs, Re, Gs, Re, Gs^Cov, 2 Re^Kov, Gs
Hhd, Hhd, Hhd^Fmw, Hhd, Gd^Fmw, Gs, Gs, Hhd, Hhd, Hhd, Hhd, Gd, Hhd, Gd^Es, Gd^Es, Rd, Gs, Gs, Gs^Es, Gd, Hhd, Hhd, Mm, Hhd, Gd^Fmw, Gs, Gd, Gd, Gs, Gs, Gs^Es, Rd^Es, Gs, Gd^Es, Hhd, Gd^Fp, Hhd, Hhd, Hhd^Fp, Gd^Fp, Wwf, Gd, Gd, Gd, Gd^Vo, Gd, Rd^Es, Rd, Rd^Dr, Rd^Es, Gd, Wwg, Wwg, Gd, Gd^Fp, Gd^Fp, Hhd, Hhd, Gd, Gs, Rd, Gs, Rd, Gd, Gd, Gs, Gs, Gs^Cov, Gs
Hhd^Fmw, Hhd^Fmw, Gd^Fmw, Gd^Fmw, Gd^Fmw, Gd, Gd, Gd^Vo, Hhd, Hhd, Hhd^Fmw, Hhd, Hhd, Gd, Gd, 5 Re, Re, Gd, Gd, Gd^Vo, Mm, Mm^Xm, Mm, Hhd^Fmw, Gd^Fmw, Gs, Rd^Es, Rd, Rd, Gs, Gd^Vo, Gs, Hhd, Gd, Hhd, Hhd, Mm, Hhd, Hhd^Fp, Hhd^Fp, Wwf, Hhd, Gd, Gd, Gd, Gd^Es, Gd^Es, Rd^Es, Rd, Rd, Rd, Wwg, Wwg, Gd, Gd^Fp, Gd^Fp, Gs^Es, Gd, Gs, Rd, Rd^Dr, Rd, Gs, Gd, Gd, Gd, Gs, Gs^Cov, Gs
Hhd^Fmw, Hhd^Fmw, Gd^Fmw, Hhd, Hhd, Hhd, Gd, Gd, Hhd^Fmw, Hhd, Hhd^Fmw, Hhd^Fdw, Hhd, Hhd, Gd, Gd, Gd, Re, Gd, Hhd, Mm, Mm, Hhd^Fdw, Hhd^Fmw, Hhd, Gd, Gd^Es, Rd^Dr, Rd^Es, Gd, Gd^Fp, Hhd, Gd^Fp, Hhd, Hhd, Mm, Mm, Hhd^Fp, Hhd^Fp, Wwf, Hhd, Hhd, Gd^Es, Gd, Gd, Gd^Es, Gd, Gd^Fp, Hhd^Fp, Gd^Fp, Gd, Gd, Wwg, Gd, Wwg, Gs, Gs, Gd, Gs, Rd^Es, Rd^Es, Hhd, Hhd, Gd^Fp, Hhd, Gs, Gd^Fp, Gs, Gs
Hhd^Fmw, Hhd^Fmw, Hhd^Fmw, Gd^Fmw, Hhd, Hhd, Hhd, Hhd, Hhd^Fmw, Hhd^Fdw, Hhd^Fmw, Hhd^Fmw, Hhd^Fmw, Hhd, Gd, Gd, Gd, Re, Gd, Gd, Gd, Hhd, Gd, Gd^Fmw, Gd, Gd, Gd, Rd^Es, Gd, Gll, Gll^Fp, Gd^Fp, Gd^Fp, Gd^Fp, Hhd, Mm, Mm, Mm, Hhd, Hhd, Gd^Es, Gd^Es, Gd, Gd, Gd, Gd, Gd^Fp, Gd^Fp, Hhd, Gd^Fp, Gd^Fp, Gd, Gd, Wwg, Wwg, Wwg, Wwg, Gs, Gs, Rd^Es, Gs^Es, Gd^Fp, Hhd, Hhd^Fp, Hhd, Hhd^Fp, Hhd, Gs, Gs
Hhd^Fmw, Hhd^Fmw, Gd^Fmw, Hhd^Fmw, Hhd^Fmw, Hhd^Fmw, Hhd, Hhd^Fmw, Hhd^Fmw, Hhd^Fmw, Hhd^Fmw, Hhd^Fmw, Hhd^Fmw, Hhd, Hhd, Hhd, Gd, Re, Re, Gd, Gd, Gd, Gd, Gd, Gd, Gd, Gd, Gd, Rb, Gd, Gll^Fp, Gd^Fp, Gd^Fp, Hhd, Hhd, Mm, Mm, Mm, Hhd^Fp, Hhd, Gd, Gd^Es, Gd, Gd^Es, Gd, Hhd, Hhd, Hhd, Hhd^Fp, Hhd, Hhd^Fp, Gd^Fp, Gd, Gd, Gd, Wwg, Wwg, Wwg, Gs, Gs, Gs, Hhd, Gd, Hhd, Hhd, Hhd, Hhd, Hhd, Gs
