Ms, Ms, Ms, Ms, Ms, Hh^Qhh, Hh^Qhh, Mm^Qhh, Mm^Qhh, Mm^Qhh, Mm^Qhh, Mm^Qhh, Mm^Qhh, Hh, Re, Re, Hhd^Qhux, Hhd^Qhux, Hhd^Qhux, Hhd^Qhux, Hhd^Qhux, Hhd^Qhh, Ms^Qhh, Ms^Qhh, Ms^Qhh, Ms^Qhh, Ms^Qhh, Gg, Hh^Qhh, Hh^Qhh, Hh^Qhh, Gg, Mm^Qhh, Mm^Qhh, Ms^Qhh, Ms^Qhh, Mm^Qhh, Mm^Qhh, Hh^Qhh, Hh^Qhh, Wo, Wo, Ww, Gs^Qhh, Re^Qhh, Re^Qhh, Hh^Qhh, Hh^Qhh, Hh^_mhh, Hh^Qhh, Hh^Qhh, Hh^Qhh, Hh^Qhh, Hh^Qhh, Gs^Fp, Gg^Fp, Gs^Fms, Gll^Fmw, Gll^Fp, Wog, Ww, Wog, Gll^Fmw, Gs^Fp, Gll^Fms, Hh^Fp, Gll^Fmw, Gs^Fmw, Gll^Fp
Ms, Ms^_mhh, Ms, Md^Qhh, Ms, Md^Qhh, Hh^Qhh, Hh^Qhh, Mm^Qhh, Mm^Qhh, Hhd^Qhh, Hhd^Qhh, Hhd^Qhh, Hhd^Qhh, Co^Qhh, Re, Re^Es, Hhd^Qhux, Gs^Es, Hhd^Qhux, Hhd^Qhux, Hhd^Qhh, Mm^Qhh, Ms^Qhh, Hh^Qhh, Ms^Qhh, Mm^Qhh, Mm^Qhh, Mm^Qhh, Hh^Qhh, Hh^Qhh, Mm^Qhh, Mm^Qhh, Ms^Qhh, Ms^Qhh, Ms^Qhh, Mm^Qhh, Mm^Qhh, Hh^Qhh, Wwr, Wo, Ww, Ww^Ewl, Gs^Qhh, Re^Qhh, Re^Qhh, Re^Qhh, Hh^Qhh, Hh^Qhh, Hh^Qhh, Hh^Qhh, Hh^Qhh, Wwr, Hh^Qhh, Hh^Qhh, Hh^Qhh, Hh^Qhh, Gll^Fms, Ww, Ww, Ww, Gs^Fp, Gll^Fmw, Gll^Fp, Hh^Fp, Gll^Fp, Hh, Gll^Fmw, Hh
Md, Ms, Ms, Md^Qhh, Md^Qhh, Md^Qhh, Md^Qhh, Hh^Qhh, Hh^Qhh, Hhd^Qhh, Hhd^Qhh, Hhd^Qhh, Hhd^Qhh, 4 Ko^Qhh, Co^Qhh, Co, Re, Gd^Es, Gd^Vo, Hhd^Qhux, Hhd^Qhh, Hhd^Qhh, Hh^Qhh, Mm^Qhh, Hh^Qhh, Hh^Qhh, Mm^Qhh, Mm^Qhh, Ww, Hh^Qhh, Hh^Qhh, Hh^Qhh, Mm^Qhh, Mm^Qhh, Mm^Qhh, Ms^Qhh, Ms^Qhh, Hh^Qhh, Hh^Qhh, Ww, Wo, Wo, Ww, Gs^Qhh, Co, Co, Co, Hh^Qhh, Hh^Qhh, Hh^Qhh, Gs, Hh^Qhh, Ww, Hh^Qhh, Gs^Fp, Hh^Qhh, Ww, Hh^Qhh, Ww, Ww, Ww, Gll^Fp, Hh, Gg, Gs^_mh, Gs, Hh, Hh, Gll^Fdw
Mm^Qhh, Md, Mm^Qhh, Md^Qhh, Mm^Qhh, Mm^Qhh, Mm^Qhh, Hh^Qhh, Hhd^Qhh, Hhd^Qhh, Hhd^Qhh, Re^Dr, Re^Dr, Co^Qhh, Co^Edb, Co^Edb, Re^Edb, Gd, Gg^Gvs, Re^Edb, Hhd^Qhh, Hhd^Qhh, Re^Es, Hh^Qhh, Hh^Qhh, Hh^Qhh, Hh^Qhh, Hh^Qhh, Hh^Qhh, Ww, Hh^Qhh, Hh^Qhh, Hh^Qhh, Mm^Qhh, Mm^Qhh, Mm^Qhh, Ms^Qhh, Mm, Ww, Hh^Qhh, Wwr, Wo, Wo, Wwg, Co, 3 Ke, Co, Cer^Ecf, Re^Qhh, Gs^Qhh, Re^Qhh, Gs^Edb, Gd^Vo, Ww, Gs^Fp, Ww, Wo, Wo, Ww, Hh, Wwr, Hh, Hh, Gg, Gs, Gd^Vo, Gs, Hh, Gll^Fp
Mm^Qhh, Mm^Qhh, Mm^Qhh, Mm^Qhh, Mm^Qhh, Mm^Qhh, Mm^Qhh, Mm^Qhh, Hh^Qhh, Mm^Qhh, Hhd^Qhh, Hhd^Dr, Re, Re, Re, Co, Re, Gs^Gvs, Gd, Re, Re, Re^Es, Re^Es, Hh^Qhh, Re, Re^Es, Re, Hh^Qhh, Hh^Qhh, Ww, Ww, Hh^Qhh, Hh^Qhh, Hh^Qhh, Ww, Mm^Qhh, Mm^Qhh, Ms^Qhh, Mm^Qhh, Ww, Hh^Qhh, Wo, Wo, Wwg, Cer^Ecf, Co, Gs^Qhh, Re^Qhh, Gs^Qhh, Re^Qhh, Gs^Qhh, Re, Gs, Ww, Ww, Ww^Ewl, Wo, Ww, Hh, Hh, Hh, Hh, Hh, Hh, Gg, Gs, Gll^Fp, Gll^Fmw, Gll^Fp
Mm^Qhh, Mm^Qhh, Mm^Qhh, Mm^Qhh, Mm^Qhh, Mm^Qhh, Mm^Qhh, Mm^Qhh, Hhd^Qhh, Hhd^Qhh, Gs^Gvs, Gs^Gvs, Re, Gs^Gvs, Gs^Gvs, Re, Gs^Gvs, Re, Gd^Vo, Gd, Gs, Gs^Es, Gs, Re, Gd, Gd^Es, Re, Co, Re, Gd, Ww, Hh^Qhh, Hh^Qhh, Ww, Hh^Qhh, Mm^Qhh, Mm^Qhh, Ms^Qhh, Mm^Qhh, Hh^Qhh, Hh^Qhh, Ww, Wo, Wo, Ww, Gs^Qhh, Ww^Ewl, Gs^Qhh, Gs^Qhh, Gs^Qhh, Gs, Re, Re, Gs, Ww, Wo, Ww, Hh, Gg^Fp, Gll^Fp, Hh, Hh, Hh, Hh, Hh, Gg^Es, Gll^Fp, Gll^Fp, Gll^Fp
Hh^Qhh, Mm^Qhh, Hh^Qhh, Mm^Qhh, Hh^Qhh, Mm^Qhh, Mm^Qhh, Hh^Qhh, Gs^Es, Hhd^Qhh, Gd, Gs^Gvs, Re, Gs^Gvs, Gs^Gvs, Gs^Gvs, Gs^Gvs, Re, Re^Edb, Re^Edb, Re, Re, Re, Re, Re^Edb, Gd^Vo, Gs, Re, Gd, Gd, Gd, Ww, Ww, Ww, Hh^Qhh, Mm^Qhh, Mm^Qhh, Ms^Qhh, Ms^Qhh, Mm^Qhh, Ww, Ww, Wo, Wo, Wo, Wo, Wo, Wo, Wo, Ww, Ww, Gs, Gs, Gs, Wo, Ww, Wwr, Gll^Fp, Gll^Fp, Gll^Fp, Gg^Fp, Hh, Gll^Fp, Gll^Fp, Gll^Fp, Gll^Fms, Gll^Fp, Gll^Fms, Gg^Fp
Hh^Qhh, Hh^Qhh, Hh^Qhh, Hh^Qhh, Hh^Qhh, Hh^Qhh, Hhd^Qhux, Hhd^Qhux, Gs, Gd, Gd^Vo, Re^Edb, Gs^Gvs, Re, Re, Re, Re, Re, Gs, Gs^Gvs, Gs^Gvs, Gs^Gvs, Gs, Gs, Gs, Re, Co, Re, Gd, Gd^Gvs, Gd^Gvs, Ww, Ww, Hh^Qhh, Hh^Qhh, Hh^Qhh, Mm^Qhh, Mm^Qhh, Mm^Qhh, Mm^Qhh, Mm^Qhh, Hhd^Qhh, Ww, Wo, Wo, Wo, Wo, Wo, Ww, Ww, Ww, Gs, Gs, Wo, Ww, Hh, Hh, Hh, Gll^Fms, Gll^Fms, Gll^Fp, Gll^Fp, Gll^Fmw, Gll^Fp, Gll^Fp, Gll^Fp, Gll^Fp, Gll^Fp, Gll^Fp
Hh^Qhh, Hh^Qhh, Hh^Qhh, Hh^Qhh, Hh^Qhh, Hh^Qhh, Hhd^Qhux, Gs^Es, Re, Re, Re, Re^Edb, Gs^Gvs, Gs^Gvs, Gd^Edb, Gd^Vo, Gd^Edb, Gs^Es, Gll^Fp, Gg, Gll^Fp, Gd^Vo, Re, Re, Re, Re, Gs, Re, Gs, Gd^Gvs, Gd^Vhr, Gd^Edb, Gd, Ww, Hh^Qhh, Hh^Qhh, Hh^Qhh, Mm^Qhh, Rb^Dr, Mm^Qhh, Rb^Dr, Hhd^Qhh, Hhd^Qhh, Hhd^Qhh, Hhd^Qhh, Hhd^Qhh, Rb^Vo, Rb, Co, Ww, Ww, Ww, Ww^Bw|r, Wo, Hh, Ww, Hh, Hh, Hh, Gs, Gs^Edb, Gs, Gs^Edb, Gll^Fp, Gll^Fp, Gll^Fp, Gll^Fp, Gll^Fp, Gll^Fp
Hh^Qhh, Hh^Qhh, Hh^Qhh, Hh^Qhh, Gg^Qhh, Hhd^Qhux, Gd^Vo, Re^Edb, Gs, Gs^Gvs, Gs^Gvs, Gs^Gvs, Hh, Gll^Fp, Mm, Gd^Edb, Hh, Hh, Hhd^Qhux, Gll^Fmf, Hhd^Qhux, Gs^Fp, Re, Co, Re, Gs, Gll^Fp, Re, Re, Gd^Edb, Gs^Edb, Gd^Gvs, Gd, Ww, Rb, Rb, Re^Es, Rb^Es, Re, Rb^Dr, Hhd^Qhh, Hhd^Qhh, Hhd^Qhh, Hhd^Qhh, Hhd^Qhh, Re, Re, Rb, Rb^Es, Wo, Ww, Ww, Ww^Bw|r, Ww, Gg, Hh, Gll^Fp, Hh, Hh, Gg^Edb, Gs^Edb, Gs^Vhr, Gs^Gvs, Gll^Fp, Gll^Fmw, Gll^Fmw, Gll^Fp, Gll^Fp, Gll^Fp
Gs^Qhh, Gs^Qhh, Gs^Qhh, Gg^Qhh, Gs^Qhh, Gd^Qhh, Re, Re, Gg, Gs, Gs^Fp, Hh, Ms, Mm, Ms^Xm, Mm, Ms, Aa, Aa, Hhd^Qhux, Hhd^Qhux, Gg, Gg, Re, Gg^Edb, Gg, Gs, Gs, Re, Gs^Edb, Gs^Edb, Gs, Gs, Ww, Ww^Bw/r, Co, Re, Re, Rb^Vo, Re, Rb^Dr, Hhd^Qhh, Co, Co, Co^Dr, Co, Re, Rb^Es, Rb^Es, Wo, Wo, Ww, Re, Gg, Gg, Gg, Gll^Fp, Hh, Gll^Fp, Hh, Gg, Gs^Gvs, Gg, Gs, Gg, Gll^Fp, Gg, Gll^Fp, Gll^Fp
Re^Qhh, Re^Qhh, Re^Qhh, Gs^Qhh, Re^Qhh, Re^Qhh, Re, Gs, Gs, Hhd^Qhux, Hhd^Qhux, Aa, Aa, Ms, Ms, Ms, Mm, Mm, Hh, Hh, Gll^Fp, Gll^Fp, Hhd^Qhux, Gg^Edb, Gd^Edb, Gg^Edb, Gs^Fms, Gll^Fp, Gs, Re, Re, Re, Re, Re, Ww, Rb, Rb^Es, Rb, Rb^Edb, Re, Re^Dr, Re^Dr, Co, Ko, Co^Dr, Re^Edb, Rb^Edb, Rb^Vo, Rb, Co, Sm, Ww, Gg, Re, Gg, Gg, Gll^Fp, Gll^Fp, Gll^Fp, Gll^Fms, Gll^Fp, Gs^Fmw, Gg, Gg, Gg, Gg, Gg, Gll^Fp, Gg
Gs^Qhh, Gs^Qhh, Gs^Qhh, Re^Qhh, Gs^Qhh, Re^Qhh, Gs^Qhh, Re, Re, Gs, Hhd^Qhux, Hhd^Qhux, Gll^Fmw, Mm, Mm, Mm, Hh, Hh, Gll^Fp, Hh, Gll^Fmw, Hhd^Qhux, Gs, Gg^Edb, Gd^Gvs, Gd^Vhr, Gd^Gvs, Gll^Fp, Gs, Re, Re, Gs, Gs, Gs, Gg, Ww, Co, Rb^Es, Rb^Edb, Re, Re, Co, Re, Co, Re, Re^Edb, Rb^Edb, Rb, Sm, Sm, Ww, Ww, Gs, Re, Re, Gg, Gg, Gll^Fp, Re^Es, Gll^Fp, Gg, Gg, Gg, Gg, Gs^Edb, Gs^Gvs, Gg^Edb, Gg, Gg
Hhd^Qhh, Hhd^Qhh, Gg^Qhh, Gs^Qhh, Hhd^Qhh, Gg^Qhh, Gg^Qhh, Gs, Re, Gg, Gs, Gg, Gll^Fp, Hh, Gg, Gll^Fp, Gll^Fp, Gs^Fms, Gll, Gg, Hhd^Qhux, Hhd^Qhux, Gs, Gd, Gs^Edb, Gd^Gvs, Gll^Fp, Gs, Re, Re, Gs, Gll^Fmw, Gll^Fp, Gs^Fms, Gg, Ww, Ww^Edb, Rb^Edb, Hhd, Rb^Vo, Hhd, Re, Rb^Edb, Re^Es, Rb, Rb^Vo, Rb^Edb, Rb^Es, Co, Sm, Re, Gg, Gs, Gs^Vo, Gs, Re, Gg, Re^Es, Co^Dr, Gll^Dr, Gg, Gg, Gg, Gs^Edb, Gs^Gvs, Gs^Vhr, Gs^Edb, Gg, Gg
Mm^Qhh, Hhd^Qhh, Hhd^Qhh, Hhd^Qhh, Mm^Qhh, Hhd^Qhh, Hhd^Qhh, Hhd^Qhux, Gs, Re, Re, Gg, Gg, Gll^Fp, Gg, Gll^Fp, Gd^Vo, Gll^Fp, Gg, Gs^Fms, Re, Re, Re, Re, Re, Gs^Edb, Gs, Gs, Re, Gd, Gd^Edb, Gd^Gvs, Gd^Gvs, Gs^Fms, Gg, Gg, Ww, Rb^Edb, Hhd, Hhd, Hhd, Rb^Edb, Rb^Edb, Rb^Edb, Rb, Rb^Edb, Rb^Edb, Sm^Edb, Sm^Edt, Sm^Bw\r, Re, Gs, Re, Gs, Re, Re, Re^Es, Re^Es, Re^Es, Re^Dr, Gs, Gg, Gg, Gg, Gg, Gs^Gvs, Gg, Gg, Gs
Mm^Qhh, Hhd^Qhh, Mm^Qhh, Mm^Qhh, Mm^Qhh, Hhd^Qhh, Hhd^Qhh, Hhd^Qhux, Hhd^Qhux, Gs^Gvs, Gd^Vo, Re^Es, Gs, Gg, Gg, Gs^Edt, Re, Gs^Edt, Re, Re, Gd, Re, Re, Co, Re, Gs, Re, Re, Gs, Gs^Edb, Gd^Edb, Gd^Vhr, Gd^Gvs, Gs^Gvs, Gd, Gg, Gg, Ww, Ww, Ww, Hhd, Hhd, Co, Rb^Edb, Sm^Edb, Co, Sm, Sm^Edb, Sm^Edt, Wwg^Edt, Wwg, Re, Gg, Re, Gs, Re^Es, Re^Dr, Co^Dr, Gll^Fp, Re^Es, Re, Gs, Gs, Gs, Gs, Gg, Gg, Gs^Cov, Gs
Ms^Qhh, Mm^Qhh, Ms^Qhh, Ms^Qhh, Mm^Qhh, Mm^Qhh, Hhd^Qhh, Hhd^Qhh, Hhd^Qhux, Gd, Gd, Re^Es, Gs, Gg, Gs, Gs, Re, Re, Gs, Gd, Gd^Gvs, Gd, Gs^Gvs, Re, Gs^Gvs, Re, Co, Re, Gll^Fp, Gs^Edb, Gg, Gd^Edb, Gs, Gd, Gs^Edb, Gd^Edb, Gs^Edb, Ww, Ww, Ww, Ww, Ww, Ww, Sm^Edb, Ww, Sm^Bw|r, Ww, Wog^Ewl, Wog, Wog^Edt, Wwg, Sm, Gg, Gg, Gs, Gg, Gll^Fp, Gll^Dr, Gll^Fp, Gs^Edt, Gs, 1 Re, Re, Gs^Vo, Re, Gg, Re^Kov, Gs^Cov, Gg
Ms^Qhh, Ms^Qhh, Ms^Qhh, Mm^Qhh, Hhd^Qhh, Hhd^Qhh, Hhd^Qhh, Hhd^Qhux, Hhd^Qhux, Gs^Gvs, Gs^Gvs, Re, Re, Gs, Re, Re, Re, Re, Gs, Gd^Gvs, Gs^Gvs, Gd^Vo, Gs^Gvs, Gs^Gvs, Re, Re, Re, Re, Gg, Gg, Gll^Fmf, Gg, Gll^Fp, Gs, Gll^Fp, Gd^Gvs, Gd^Vhr, Gll^Edb, Ss, Gll, Sm, Ww, Gll, Ww, Ww, Ww, Ww, Ww, Wwrg, Wog^Edt, Wog^Edt, Wwg, Wwrg, Gs, Gs^Vo, Gs, Gs, Gll^Fp, Gll^Fms, Gs, Gg, Gs, Gg, Re, Gs, Re, Rb^Cov, 2 Re^Kov, Re
Ms^Qhh, Ms^Qhh, Mm^Qhh, Mm^Qhh, Mm^Qhh, Hhd^Qhh, Mm^Qhh, Hhd^Qhh, Hhd^Qhux, Gs^Gvs, Gd^Gvs, Gd^Vo, Re^Es, Re, Co, Co, Re, Gs, Re, Gs^Es, Gs^Es, Re, Gs^Gvs, Gs^Gvs, Re, Gd, Re, Re, Re, Gll^Fp, Gll^Fp, Gll^Fp, Gll^Fp, Gg, Gll^Fmw, Gs^Edb, Gll^Edb, Gll^Edb, Gll, Gll, Gg, Gll, Gll^Em, Sm, Sm, Sm, Gll, Ss, Wwg, Wog, Wog, Wwg, Wwg, Gg, Gg, Gs, Gg, Gs, Gg, Gs, Gg, Gg, Gs, Gs^Edb, Gs^Edb, Gg, Gg, Gs^Cov, Gg
Ms^Qhh, Ms^Qhh, Ms^Qhh, Mm^Qhh, Mm^Qhh, Mm^Qhh, Hhd^Qhh, Hhd^Qhh, Hhd^Qhh, Hhd^Qhh, Gs, Gd, Re, Co, 5 Ko, Co, Re, Re, Gd^Vo, Re, Re, Re, Re, Re, Gs^Gvs, Gd^Vo, Re^Es, Co, Re, Gll^Fp, Gs^Fms, Gg, Gll^Fp, Gll^Fp, Gs^Fms, Gll^Fp, Gll^Fp, Ss, Gll^Fms, Gll^Em, Gg, Gg, Gll^Fms, Ss, Gll, Gll, Gll^Em, Wwrg, Sm, Wog, Wog^Ewl, Wog^Edt, Wwg, Gg, Re^Fp, Gll^Fms, Gll^Fmw, Gll^Fp, Ss, Gg, Gg, Gg, Gg, Gs^Gvs, Gs^Vhr, Gs^Gvs, Gg, Gg^Cov, Gg
Mm^Qhh, Ms^Qhh, Ms^Qhh, Ms^Qhh, Ms^Qhh, Mm^Qhh, Mm^Qhh, Hhd^Qhh, Hhd^Qhh, Hhd^Qhh, Hhd^Qhh, Hhd^Qhh, Re, Co, Co, Co, Re, Gd, Gd^Gvs, Gd^Gvs, Gs^Gvs, Gd^Gvs, Gd^Vo, Gd^Gvs, Gs^Gvs, Gs^Gvs, Gll^Fp, Re, Gs^Fms, Gll^Fp, Gs^Fp, Gll^Fp, Gll^Fp, Gs^Fms, Gll^Fp, Gll^Fp, Gll^Fp, Gll^Fp, Gll, Ww^Ewl, Sm, Gll, Gg, Gll, Gg, Gg^Em, Gll^Em, Ss^Vhs, Ss, Ss, Sm, Wog, Wog, Wwrg, Wwg, Gll^Fp, Gll^Fms, Gll^Fp, Gll^Fms, Gll^Fp, Gll^Fp, Gll^Fp, Gg, Gs, Gg^Edb, Gg^Edb, Gg, Gg, Gg
Mm^Qhh, Mm^Qhh, Mm^Qhh, Mm^Qhh, Mm^Qhh, Mm^Qhh, Mm^Qhh, Mm^Qhh, Mm^Qhh, Hhd^Qhh, Hhd^Qhh, Hhd^Qhh, Re^Edt, Re^Edt, Re, Re, Hhd^Qhux, Hhd^Qhux, Hhd^Qhux, Hhd^Qhux, Hhd^Qhux, Gd, Gll^Fp, Gs, Gll^Fp, Gs, Gll^Fmw, Gll^Fmf, Gs^Fp, Gll^Fp, Gs^Fp, Gll^Fp, Gll^Fp, Gs^Fms, Gll^Fp, Gll^Fmw, Gs^Fp, Gll^Fp, Gll^Em, Sm, Sm, Gll^Em, Gg, Gg, Gg, Gg, Gll^Fp, Gll^Fms, Gll^Fms, Ss, Ss, Ss, Wog, Wog, Wog, Ss, Ss, Gll^Fmw, Gll^Fp, Gll^Fmw, Gll^Fms, Gll^Fp, Gll^Fp, Gg, Gg, Gg, Gg, Gg, Gg
Gg, Hh^Qhh, Hh^Qhh, Hh^Qhh, Hh^Qhh, Mm^Qhh, Mm^Qhh, Mm^Qhh, Mm^Qhh, Mm^Qhh, Gg, Re, Re, Re^Edt, Re, Ha^Qhu, Hhd^Qhux, Hhd^Qhux, Ha^Qhu, Hhd^Qhux, Hh, Gll^Fp, Gll, Gll^Fp, Gg, Gll^Fp, Gg, Gll^Fp, Gg, Gs^Fms, Gll^Fp, Gll^Fp, Gg, Gll^Fmf, Gg, Ss, Ss, Sm, Ss, Gll^Fp, Gll^Em, Gll^Em, Gll, Gg, Gg, Gg, Ww^Ewl, Gll^Fp, Gll^Fp, Ss, Ss, Ss, Wog, Wog^Ewl, Wwg, Ss, Ss, Gll^Fp, Gll^Fp, Gll^Fp, Gll^Fms, Gll^Fp, Gll^Fp, Gs^Fmw, Gs, Gg, Gs, Gg, Gg^Em
