Ms^Xm, Ms^Xm, Ms^Xm, Ms^Xm, Ms^Xm, Ms, Mm, Md, Hh, Md, Hh, Hh, Hh, Re, Re^Es, Re, Hh, Hh, Hh, Hh, Mm, Mm, Ms, Ms, Ms, Wog, Wog, Mm, Mm, Mm, Ms, Ms, Mm, Hh, Mm, Hh, Hh, Gs, Rb, Rb, Rb, Rb, Re^Edb, Gll^Fms, Gll^Fdw, Hh^Fp, Gs^Fp, Gs, Hh, Hh, Hh, Hh, Hh, Hh, Gs^Fp, Gg^Fp, Gs^Fp, Gs^Fp, Gll^Fp, Wog, Wwg, Wog, Gll^Fdw, Gll^Fp, Gll^Fdw, Hh^Fp, Gll^Fp, Gg^Fp, Gll^Fmw
Ms^Xm, Ms^Xm, Md, Ms^Xm, Mm, Ms^Xm, Ms, Mm, Mm, Hh, Mm, Hh, Hh, Re, Hh, Rb^Es, Gs^Gvs, Hh^Fds, Gs^Fp, Gll^Fmw, Mm, Mm, Mm, Ms, Mm, Mm, Wog, Mm, Mm, Mm, Mm, Ms, Ms, Ms, Mm, Mm, Hh, Hh, Chr, Cer, Cer^Edb, Rb^Edb, Re^Edb, Re, Gll^Fp, Gs^Fp, Gll^Fms, Gs^Es, Hh^Fp, Hh, Hh^Fp, Hh, Hh, Hh, Hh, Hh, Hh, Gll^Fp, Wwrg, Wog, Wwrg, Gs^Fms, Gll^Fdw, Gll^Fp, Hh^Fp, Gll^Fp, Hh, Gll^Fp, Hh
Md, Md, Hh, Mm, Hh, Mm, Mm, Mm, Mm, Mm, Ms, Ms^Xm, Ms, Mm, Mm, Rb, Rb, Re^Vo, Gs^Fp, Hh^Fp, Hh, Hh, Mm, Wwrg, Wog, Hh, Wog, Wog, Mm, Mm, Mm, Wwrg, Mm, Ms^Xm, Ms^Xm, Hh, Mm, Hh, Chr, 3 Ker, Cer, Rb^Edb, Rb, Rb, Rb, Rb, Rb^Edb, Gs^Fp, Rb, Gg^Fp, Re, Gs, Gs^Es, Hh, Gs^Fp, Hh, Wwg, Hh, Wog, Wog, Wwg, Gll^Fmw, Hh, Gs, Gg, Gs^Es, Hh, Hh, Gll^Fdw
Md, Md, Md, Hh, Mm, Mm, Mm, Mm, Mm, Mm, Mm, Ms, Mm, Mm, Coa^Edb, 4 Ko, Co, Rb, Re^Vo, Hh, Hh^Fp, Hh^Fp, Mm, Mm, Hh, Wog, Hh, Wog, Wog, Mm, Wog, Wog, Mm, Ms^Xm, Ms^Xm, Mm, Ms, Mm, Hh, Chr, Hh, Hh, Chr, Rb, Gs^Edt, Re, Gs^Vhr, Rb^Edb, Gs, Rb, Rb, Gs^Edb, Gg^Vhr, Wwg, Gs^Fp, Gs^Es, Wwrg, Wwg, Wwrg, Hh, Wwg, Hh, Hh, Gs, Gs^Edt, Gs^Vl, Gg, Hh, Re^Fp
Re, Hh, Hh, Hh, Mm, Gs^Fp, Gs^Fp, Mm, Hh, Mm, Mm, Mm, Hh, Hh, Co^Edb, Co^Edb, Rb^Edt, Rb, Re^Em, Gg^Fms, Gs^Fp, Gs^Fp, Hh^Fp, Hh, Hh, Hh, Wwg, Wog, Mm, Wog, Wog, Mm, Hh, Mm, Wwrg, Ms, Ms, Mm, Mm, Mm, Mm, Mm, Hh, Re, Hh, Gs, Hh, Gg^Edb, Hh, Re, Hh, Rb^Edb, Re^Edb, Wwg, Wwg, Wog, Hh, Gg^Fms, Hh, Hh, Hh, Hh, Hh, Hh, Gg, Gs^Es, Gg^Fp, Gll^Fdw, Gll^Fdw
Re, Re, Re, Hh, Re^Vo, Mm, Gs^Fp, Hh^Fp, Hh, Hh, Re^Vo, Hh, Gs^Em, Hh, Cer, Co, Rb^Edt, Rb^Vo, Gs^Fp, Hh^Fp, Co, Gs^Fp, Gs, Hh^Fp, Hh^Fds, Wwrg^Edt, Khw^Esa, Ch, Chr^Esa, Ms, Mm, Wog, Wog, Hh, Wog, Mm, Mm, Ms, Mm, Mm, Mm, Mm, Mm, Hh, Mm, Mm, Mm, Mm, Mm, Hh, Hh, Rb, Rb, Gs, Wwrg, Ww^Ewl, Gs^Es, Hh, Gll^Fdw, Gll^Fp, Hh, Hh, Hh, Hh, Hh, Gg^Es, Hh^Fp, Hh^Fp, Gs^Fmw
Gs, Gs, Re, Re^Es, Hh, Mm, Mm, Hh^Fms, Hh, Gs^Es, Re^Edt, Re^Edt, Re^Vo, Re, Rb, Rb^Edt, Gs^Edt, Re^Edt, Gs^Gvs, Re^Es, Re^Es, Re^Es, Hh, Gs^Fp, Hh, Wwg^Edt, Ww^Ewl, Wwrg^Edt, Hh^Edt, Mm, Hh^Fp, Wog, Wog, Wog, Hh, Mm, Mm, Mm, Hh, Mm, Mm, Mm, Mm, Mm, Mm, Mm, Mm, Wwg, Wwg, Mm, Gs^Edb, Hh, Rb^Edb, Re, Wo, Wwg, Gll, Gs^Fms, Hh^Fp, Gll^Fmw, Gg^Fp, Hh, Gll^Fms, Hh^Fp, Gs^Fp, Gll^Fms, Gll^Fp, Hh^Fp, Gs^Fp
Hh, Hh, Gs^Es, Re, Re, Hh, Hh, Hh^Fp, Hh^Fp, Re^Vo, Gs^Gvs, Re^Edt, Gs^Gvs, Rb, Gs^Edt, Gs^Gvs, Re^Vo, Gs^Gvs, Hh, Hh, Hh, Hh, Gll^Fmw, Gs^Fp, Hh, Hh, Wwf, Re^Vo, Hh, Hh^Fp, Hh^Fp, Hh^Fp, Wwg, Hh^Fms, Gs^Fp, Hh^Fms, Mm, Mm, Hh^Fms, Mm, Mm, Hh, Hh, Mm, Hh^Fms, Hh, Hh, Hh, Wwg, Hh, Gg^Vhr, Re^Edb, Re^Edb, Wo, Wwg, Hh, Hh, Hh, Hh^Fp, Gs^Fms, Gg^Fp, Gs^Fp, Gll^Fmw, Hh^Fp, Gs^Fp, Gg, Hh^Fp, Gs^Fp, Gll^Fms
Mm, Hh, Hh, Gs, Re, Hh^Fp, Gs^Fp, Hh, Co, Gs^Em, Hh^Fmw, Hh, Hh^Fmw, Rb, Rb, Gs^Gvs, Re^Es, Gs^Es, Re, Chr, Rp, Gs^Em, Gs, Gs^Fp, Gg, Gs, Gs, Wwf, Wwf, Wwf, Chw^Ewl, Wwg, Wwrg, Gg^Fp, Gs^Fp, Hh^Fp, Re, Hh^Fp, Hh^Fp, Hh^Fms, Hh^Fp, Hh^Fms, Gll^Fp, Hh^Fp, Hh, Gll^Fp, Gll^Vo, Re, Co^Es, Ww^Ewl, Wwg, Ww^Ewf, Wwg^Bw|r, Wo, Hh, Wwg, Hh, Hh, Hh, Gs, Gg^Edt, Gll, Gs^Es, Gs^Fp, Gll^Fp, Gll^Fdw, Gll^Fmw, Hh^Fp, Gs^Fp
Ms, Mm, Hh, Re^Vo, Gs^Es, Re, Gs^Fp, Hh, Gs^Em, Gs^Fms, Hh, Hh, Hh, Gs^Fp, Rb^Es, Co, Rb^Es, Re, Rp^Es, Re, Gs^Es, Re, Re, Re, Re^Es, Gs^Es, Gs^Es, Gs, Rp^Es, Rp^Es, Re, Wwg, Gg, Gg, Re^Es, Gs, Re^Edb, Co^Es, Re, Re^Fp, Co^Es, Re, Rb^Edb, Hh, Rb, Rb, Rb, Re, Re, Wo, Rb, Gs, Re, Gs, Gs^Es, Hh, Gll^Fp, Hh, Hh, Gs^Gvs, Gs^Gvs, Rb^Vc, Rb, Gll^Fmw, Gll^Fdw, Gll^Fp, Gs^Fp, Gs^Fp, Gll^Fp
Ms, Mm, Mm, Hh, Hh, Re, Re, Gs, Gs^Fp, Hh^Fds, Hh^Fp, Mm, Mm, Mm, Mm, Rb, Rb, Gs, Gs, Gs, Gs^Fds, Gs^Edb, Rp^Edb, Rp^Edb, Rb^Em, Re, Re, Re, Re, Re^Es, Chr^Dr, Wwf, Re, Re^Es, Re^Dr, Re^Vo, Gll, Re^Edb, Gll, Re^Fp, Re^Edb, Rb^Edb, Cer, Co, Co, Cer^Dr, Rb^Edb, Gll^Edb, Gll^Edb, Wo, Wog, Rb, Gg, Gg, Gs, Gs^Es, Gg^Fp, Hh, Gll^Fdw, Hh, Gs^Gvs, Rb, Re, Gs^Gvs, Gg, Gll^Fp, Gs, Gll^Fp, Gll^Fms
Mm, Ms, Mm, Mm, Mm, Gs, Re, Re, Re, Re, Re^Es, Re^Es, Re, Mm, Re^Edt, Rb^Edt, Co, Gs^Es, Hh, Gg^Fms, Hh^Fms, Co, Chr^Em, Rb^Dr, Hh^Fms, Gg^Fds, Gs^Fds, Gg, Gs^Edb, Rb^Es, Rp, Wwg, Wwg, Ww^Ewl, Gs, Gll^Edb, Gll^Fp, Gll^Vo, Gs^Es, Gll^Vo, Rb, Rb^Fp, Co^Fmw, Ko^Fdw, Cer, Rb^Edb, Gs^Edb, Gll^Vo, Re, Gll^Edb, Ss, Rb, Rb, Gs, Gs, Gs, Gll^Fmw, Gll^Fdw, Gll^Fp, Gs^Fp, Gll^Fms, Gll^Fp, Gs, Re, Gs, Gs, Gg^Em, Gg^Fp, Gs
Hh, Mm, Mm, Mm, Mm, Hh, Re, Gs, Gs, Gs, Gs, Gs, Gs, Re, Gs, Re, Re, Re, Hh, Hh, Mm, Mm, Mm, Khr, Hh, Rp, Gs^Fds, Hh, Rp^Edb, Rb^Edb, Wwf, Wwf, Gs, Wwg, Wwg, Wwrg, Re^Edb, Gs^Edb, Gs^Es, Gs^Es, Rb, Co^Fp, Rb^Edb, Cer^Es, Rb, Rb^Edb, Gs^Es, Re^Es, Co, Gll^Fp, Ss, Gll^Fp, Gs^Gvs, Gs^Gvs, Gg^Es, Gs, Gg, Gll^Fp, Re, Gll^Fms, Gs, Gs, Gg, Gs^Es, Gg^Gvs, Gs^Es, Gs, Gs^Es, Gs
Hh, Hh, Hh, Mm, Mm, Re, Chr, Re, Gs, Gg^Gvs, Gd^Vo, Gs^Gvs, Gg^Gvs, Gg, Re, Re, Hh, Hh, Mm, Ms, Ms, Ms, Ms, Mm, Mm, Khr^Vhcr, Hh, Hh, Hh, Rp^Edb, Wwf^Edb, Gs^Fp, Gg, Wwrg, Wwg, Co, Re, Gll^Edb, Sm^Vo, Ss^Fp, Gll^Edb, Rb, Wwrg^Edb, Rb^Edb, Gll^Fp, Gll^Vo, Re, Re^Es, Re, Ss, Re, Gll^Fp, Gg^Gvs, Gs^Vl, Gs^Gvs, Gs, Gs, Re, Cer^Fp, Gll^Fms, Gg, Gs, Gg, Gs^Gvs, Rb, Rb^Vc, Gg^Gvs, Gg^Gvs, Gg
Hh, Wog, Wog, Hh, Gg, Re^Es, Re^Es, Re, Hh, Hh, Gs^Fds, Gs, Re^Es, Re, Gg, Gg, Hh, Hh, Hh, Mm, Gs^Fms, Mm, Hh, Mm, Mm, Mm, Mm, Chr^Es, Khw, Ss, Chr^Fp, Gs^Fp, Gg^Fp, Gs, Gg^Es, Wwf, Wwg, Wwg, Wwg, Ss, Sm, Sm, Cer, Re^Edb, Re, Gll^Fp, Re^Dr, Cer^Fp, Sm^Edt, Ss^Bw\r, Re, Gs, Re, Gs^Gvs, Re, Gg^Edt, Re, Re, Re, Re, Gs, Gs, Gs, Gs^Es, Re, Gs^Gvs, Gll, Gs^Es, Gs
Mm, Wo, Wwrg, Wwrg, Re, Re, Gg, Gg, Gs^Fds, Gll^Fp, Gs^Fds, Gs, Re, Re, Rb^Es, Hh, Gll, Hh, Gll^Fp, Hh^Fms, Gs^Fds, Gs^Fds, Hh, Hh, Co, Mm, Wwf^Edt, Chr^Edt, Wwf^Edt, Ss, Ww^Ewl, Sm, Gg, Gs, Gg^Es, Gs^Es, Gll, Gll^Es, Gll, Wo, Wo^Ewl, Sm^Edt, Sm^Edt, Co, Sm, Re, Sm, Ss, Wo^Edt, Wwg^Edt, Wwg, Re, Gg^Edt, Re, Gs, Re, Re, Cer^Fp, Gll^Fp, Re, Re, Gs, Gs, Gs, Gs, Gg^Edt, Gg, Gs^Cov, Gs
Mm, Hh, Hh, Re^Es, Gs, Re^Es, Gg, Gs^Fds, Gg, Gs^Fds, Gs, Hh^Fms, Re, Rb^Es, Co, Rb, Rb^Vo, Gs^Gvs, Rb^Vo, Gs, Gs, Gs^Fds, Gs, Re, Wwg^Bw\r, Wwg, Re, Wwf^Edt, Re, Chr, Wo^Bw\r, Re, Re, Re, Re, Re, Re, Re, Re, Wwrg, Wog, Wog^Edt, Wwg, Sm, Wwg, Sm, Wwg, Wog^Ewl, Wog, Wog^Edt, Wwg, Sm, Gg, Gs^Gvs, Gs^Gvs, Gs, Gs^Fmw, Hh^Fp, Gs^Fp, Gs^Edt, Gs, 1 Re, Re, Rb^Vo, Re, Gs, Re^Kov, Gs^Cov, Gg
Mm, Hh, Hh, Hh, Hh, Re, Re, Re, Re^Es, Re^Es, Re^Es, Gll, Rb^Edt, Cer, Co^Edb, Rb^Edb, Rb^Edb, Rb, Gll^Gvs, Gs^Gvs, Re, Re, Re^Es, Re, Wwg, Re, Gg, Re, Gll, Re, Wo, Chr, Gs^Es, Gll, Mm, Hh, Gs^Fp, Gll^Es, Gll, Re, Wog^Bw\r, Wwg, Gll, Sm, Gll, Wwg^Bw|r, Rb, Rb, Wwrg, Wog^Edt, Wog^Edt, Wwg, Wwrg, Gs^Gvs, Gs^Vc, Gs^Edt, Gs^Gvs, Gll^Fmw, Gs^Fp, Gs, Gs, Gs, Gs, Re, Gs, Re, Rb^Cov, 2 Re^Kov, Re
Mm, Hh, Hh, Hh, Hh, Gg, Re, Hh, Hh, Hh, Gs^Gvs, Re, Rb, Co, Co, Co^Edb, Re, Rb^Vo, Re^Es, Re, Hh, Hh, Mm, Hh, Wwg, Gg^Fp, Hh, Gs^Es, Gs^Fp, Hh, Mm, Ww^Ewl, Rb, Hh, Mm, Hh, Hh, Hh, Wog, Gll, Wog, Re, Re^Em, Re, Rb^Edb, Rb^Edb, Rb^Em, Ss, Wwg, Wog, Wog, Wwg, Wwg, Gs^Edt, Gs, Gs^Edt, Gs^Es, Gs, Gs, Gs, Gs, Gs, Gs, Gs, Gs, Gs^Gvs, Gs^Gvs, Gs^Cov, Gs^Edt
Mm, Mm, Mm, Mm, Hh, Hh, Gd^Es, Re^Vo, Gs^Fms, Gs^Gvs, Gs^Gvs, Re^Vo, Re, Re^Es, Re^Es, 5 Ko, Re, Gll^Gvs, Re, Gs^Fds, Mm, Mm, Mm, Wwg, Hh, Hh, Hh^Vhhr, Rb, Gg^Fp, Mm, Hh, Wwrg, Rb, Hh, Hh, Mm, Mm, Wog, Hh^Fp, Wog, Wwf, Gll^Fp, Gll^Fmw, Gll, Gs^Edb, Rb^Edb, Gll^Fp, Wwrg, Sm, Wog, Wog^Ewl, Wog^Edt, Wwg, Gg^Es, Gs^Fp, Gs^Fp, Gll^Fp, Re^Fp, Ss, Gs^Es, Gg, Gll, Gg, Gs, Rb^Vl, Gg^Gvs, Gs, Gg^Cov, Gs^Edt
Ms, Mm, Ms, Hh, Mm, Hh, Gs^Fds, Re, Gs^Fds, Gs^Fds, Gll^Fp, Gs^Gvs, Re^Vo, Re^Es, Gs^Vo, Re^Es, Gll^Gvs, Re, Gs^Fds, Hh, Mm, Ms, Md, Md, Md, Md, Md, Gg^Dr, Mm, Rb, Hh^Vhhr, Wo, Wo, Ur^Dr, Hh^Vhhr, Mm, Mm, Wog, Hh^Fp, Wwf, Gs, Gll^Fp, Gll^Em, Gll, Gll, Rb^Em, Gll^Fdw, Ss^Vhs, Ss, Ss, Sm, Wog, Wog, Wwrg, Wwg, Gll^Fp, Gs^Fp, Gg^Fp, Gs^Fp, Gll^Fp, Gll^Fmw, Gll^Fms, Gs^Es, Gg^Gvs, Gs^Gvs, Gs^Es, Gg, Gs, Gs^Es
Mm, Ms, Ms, Mm, Mm, Hh, Gs^Fds, Gs^Fds, Gll^Fp, Gs^Fds, Gs^Fds, Gs^Fds, Gs^Fds, Hh^Fms, Gs^Fms, Gs^Fds, Gs, Re, Gs, Gs^Fds, Hh, Md, Md, Hh, Hh, Md, Hh, Mm, Mm, Mm, Hh^Fp, Hh^Fp, Mm, Wo, Mm, Ms, Ms, Mm, Hh, Hh, Gll^Fp, Gs^Em, Gs^Em, Gll, Gll^Es, Gll^Fp, Gll^Fmw, Gll^Fp, Sm, Ss, Ss, Ss, Wog, Wog, Wog, Ss, Ss, Gg^Fds, Gll^Fms, Gll^Fp, Hh^Fp, Hh^Fp, Gll^Fp, Gs^Gvs, Gs^Gvs, Gs, Gs^Es, Gg^Em, Gs
Mm, Ms, Ms, Ms, Mm, Mm, Gs^Fds, Gs^Fms, Hh^Fmw, Gs^Fds, Hh^Fms, Gs^Fds, Hh^Fmw, Gs^Fds, Hh, Hh, Gd, Re, Re, Gll^Fp, Hh, Hh, Hh, Md, Hh, Hh, Hh, Hh, Rb, Hh^Fp, Hh^Fp, Hh^Fp, Hh^Fp, Mm, Mm, Ms, Mm, Mm, Hhd^Fp, Hh, Gll^Fp, Gll^Fp, Gd, Gll, Gd, Gll^Fp, Rb, Ss, Ss, Ss, Ss, Ss, Wog, Wog^Ewl, Wwg, Ss, Ss, Gll^Fdw, Gll^Fp, Gs^Fp, Gg^Fp, Hh^Fp, Gg^Fp, Gll^Fms, Gs, Gg, Gs, Gll^Es, Gg^Em
