Hhd, Hhd, Mm, Hhd, Mm^Xm, Mm^Xm, Mm^Xm, Mm, Hhd, Hhd, Hhd, Hhd, Hhd, Gd, Re, Gd, Hhd, Hhd, Hhd, Hhd, Mm, Mm, Mm^Xm, Mm^Xm, Mm^Xm, Wwg, Ai, Mm, Mm, Md^Xm, Md^Xm, Hhd, Hhd, Gs, Gs, Gs, Gs, Gs, Re, Gs, Gd^Fp, Gd, Hhd, Hhd, Hhd, Hhd, Hhd, Hhd, Hhd, Gd, Gd^Fp, Gs, Gs, Gs, Gd^Fp, Gd, Hhd, Gd, Hhd, Gd^Fp, Gd^Fp, Gll^Fp, Gll^Fp, Gll^Fp, Gll^Fp, Gll^Fp, Gll^Fp, Gll^Fp, Gll^Fp
Hhd, Hhd, Hhd, Mm, Mm, Mm^Xm, Mm, Mm, Hhd^Fdw, Ha, Aa, Gll^Fmw, Re^Esa, Gd, Gd^Es, Re, Gd, Hhd, Hhd, Hhd, Mm, Mm, Mm, Mm, Mm, Wwg, Wwg, Ha, Mm^Xm, Md^Xm, Mm, Mm, Hhd^Fp, Gd^Fp, Hhd, Gll^Fmw, Gd^Fp, Rd, Re^Cov, Rd^Cov, Rd^Cov, Rd, Gd^Fp, Hhd^Fp, Hhd^Fp, Hhd, Hhd, Hhd, Hhd^Fp, Hhd^Fp, Gd^Fp, Gd^Fp, Gd, Gs, Gll^Fmw, Gd^Fp, Hhd, Hhd, Hhd, Gd^Fp, Gll^Fmw, Gll^Fp, Gd, Gd^Es, Gd, Gll^Fp, Gll^Fp, Gll^Fp, Gll^Fp
Hhd, Hhd, Hhd, Hhd, Hhd, Mm, Mm, Mm, Hhd^Fdw, Hhd, Aa, Aa^Voa, Re, Gd^Vo, Re^Es, Re, Hhd, Hhd, Hhd, Ha, Aa^Esa, Aa^Esa, Mm, Mm, Aa, Ha, Wwg, Wwg, Ai^Esa, Mm^Xm, Mm, Mm, Mm, Mm, Mm, Hhd^Fp, Gd^Fp, Gd^Es, Rd^Cov, 3 Re^Kov, Re^Cov, Gd^Es, Re, Hhd, Re, Gd^Fp, Re, Re^Vo, Re, Hhd, Gs, Gd^Es, Gs, Gd, Gd, Gd^Es, Gd^Fp, Hhd^Fp, Gs, Gs, Gd^Es, Rd^Es, Rd^Dr, Rd, Gd, Gll^Fp, Gs, Gll^Fp, Gll^Fp
Gd, Gd, Hhd, Hhd, Ha, Mm, Mm, Mm, Mm, Gd^Fdw, Re^Fmw, Re^Esa, Gll^Vo, Re^Edt, Co, 4 Ko, Co, Hhd^Fdw, Gd^Fdw, Hhd^Fdw, Hhd^Fdw, Aa, Mm, Mm, Hhd, Ai^Esa, Ai, Wwg, Wwg, Ha, Wwf, Wwf, Mm, Mm, Mm, Md^Xm, Mm, Hhd, Gs, Rd^Cov, Gs^Es, Re^Es, Gd, Re, Gs, Re, Gd, Rd, Rd, Gs, Gs, Gll^Fmw, Hhd, Gd^Fp, Hhd, Gd, Gs, Gd^Fp, Hhd, Gs, Rd, Rd^Es, Rd^Es, Rd, Rd, Gd, Gd^Es, Gll^Fp, Gs
Re, Gd, Gd^Esa, Aa, Hhd, Hhd^Fdw, Hhd, Mm, Re, Re^Es, Hhd, Re, Gll, Gll, Co, Co, Gd^Edt, Gll^Fmw, Gd, Gll^Fmw, Hhd, Hhd^Fdw, Hhd, Hhd, Hhd^Fdw, Hhd, Wwg, Wwg, Mm, Wwg, Wwg, Mm, Hhd, Mm, Mm, Md^Xm, Md^Xm, Mm, Mm, Hhd, Hhd, Hhd, Hhd, Gd^Fp, Hhd, Hhd, Gs^Es, Rd^Es, Rd^Dr, Rd^Es, Gs, Hhd, Gd^Fp, Hhd^Fp, Hhd, Gd, Gd, Re^Vo, Gd, Gs, Gd, Gd^Es, Gd^Es, Gs, Gd^Fp, Gll^Fp, Gd^Es, Gs^Es, Gs
Re, Re, Re, Aa^Esa, Re^Vo, Hhd, Gd^Fdw, Gd^Edt, Re^Edt, Gd^Es, Hhd, Gd^Es, Hhd, Gll, Gd, Re^Edt, Hhd, Hhd, Hhd, Gd, Co, Hhd, Rd^Es, Hhd, Gd, Wwrg^Edt, Khw^Esa, Cha, Chr^Esa, Mm, Mm, Wwg, Wwg, Hhd, Hhd, Mm, Mm, Mm, Mm, Mm, Md^Xm, Hhd^Fp, Mm, Hhd, Mm, Hhd^Fp, Gd^Fp, Rd, Rd, Rd^Es, Rd, Gd^Fp, Gd^Fp, Hhd, Gd, Hhd, Gd, Re, Gd^Es, Gd^Es, Rd, Gd, Rd, Gd, Gd^Fp, Gll^Fmw, Gll^Fp, Gd, Gs
Gd, Gd, Re, Re, Gd, Hhd, Hhd, Gll^Fmw, Re^Es, Hhd, Aa, Hhd, Hhd, Hhd, Gd^Vo, Re, Hhd, Hhd^Fdw, Hhd, Hhd, Re, Rd, Rd^Dr, Rd^Es, Hhd, Wwg^Edt, Wwg^Edt, Wwrg^Edt, Hhd^Edt, Mm, Hhd, Wwf, Wwg, Ai, Hhd, Mm, Mm, Mm, Mm, Mm, Mm, Mm, Mm, Mm, Mm, Mm, Mm, Mm, Hhd, Gs^Es, Gs, Gd, Gd, Rd, Rd, Gs, Re, Re, Gd^Es, Rd^Es, Rd^Dr, Rd, Gd, Gd, Gs, Gd, Gd, Gd, Gs
Gs, Gd^Es, Gd, Re, Re, Gd, Gd, Chr, Hhd, Hhd, Mm, Mm, Mm, Hhd, Hhd, Re, Re^Es, Gd, Gs, Hhd, Re, Rd, Gd^Es, Gd^Es, Gd, Hhd, Aa^Esa, Re^Vo, Aa^Esa, Hhd, Aa, Hhd, Wwg, Hhd, Gs, Hhd, Mm, Mm, Hhd, Mm, Mm, Mm, Hhd, Mm, Hhd, Hhd, Hhd, Hhd, Hhd, Gd^Fp, Gs, Gd^Es, Gd^Es, Rd, Rd^Dr, Rd^Es, Rd^Es, Gs, Gd, Rd, Rd, Rd, Gd, Gd, Rd^Es, Rd, Rd, Gs, Gs
Aa, Aa, Gs^Esa, Gd, Re, Gd, Gd, Hhd, Rd^Esa, Aa^Esa, Aa, Mm, Mm, Hhd^Fmw, Gd, Gd^Es, Re, Gd, Re, Gd, Re, Re^Vo, Re, Re, Re, Gd, Re, Re^Esd, Gd, Gd^Esa, Chr, Wwg, Wwrg, Gs^Es, Gs^Es, Hhd, Gd, Hhd, Hhd, Hhd, Hhd, Hhd, Hhd^Vo, Hhd, Hhd, Re, Rd^Es, Rd^Dr, Rd, Rd, Gd, Gd, Gs, Rd, Rd, Rd^Es, Gs^Es, Gs, Gd, Gd, Gd^Fp, Gs, Gd, Gd^Es, Rd^Es, Rd^Dr, Rd, Gs, Gs
Gs, Aa^Esa, Gd, Re^Vo, Gd, Re, Gd^Es, Rd^Dr, Rd, Aa, Hhd, Hhd^Fdw, Mm, Hhd, Aa^Esa, Co, Re^Es, Re, Gd, Re, Gd, Re, Rd, Gd^Esd, Gd, Re, Gd, Re, Re, Re, Re, Wwg, Gd, Gs^Es, Re, Re^Vo, Gd, Gd, Gll, Re, Co^Dr, Re^Es, Re, Hhd, Co^Dr, Co^Es, Cer, Rd, Rb, Rb, Rb, Gs, Gs, Rd, Gs^Es, Rd, Re, Re, Re, Gs, Gs, Gs, Gs, Gd, Gd, Rd, Gd, Gd, Gs
Gd^Es, Gs^Es, Rd^Es, Rd, Gd^Es, Re, Re, Rd, Gd^Es, Gd^Vo, Gd, Gd^Fmw, Mm, Mm, Mm, Re, Re, Gs, Gs^Esa, Gd, Gd, Rd, Rd^Dr, Rd^Edt, Rd^Edt, Gd^Edt, Re^Vo, Re, Gd, Gd, Chr, Wwg^Bp\, Re, Re, Gs^Es, Re, Re, Re, Re, Re^Es, Re, Re^Edt, Re^Edt, Co^Es, Co^Dr, Cer, Re^Edt, Re^Edt, Rb, Sm, Sm, Rb, Gd, Gs, Gs, Re, Gd, Gd, Gs, Re, Re, Re, Re, Re^Vo, Gs, Gd, Gd, Gll^Fp, Gll^Fp
Gd^Es, Gd^Es, Rd, Rd^Dr, Rd^Es, Gd, Re, Re, Re, Re, Re^Es, Re^Es, Re, Mm, Re^Edt, Re^Edt, Co, Gs, Aa, Gd^Fdw, Hhd^Esa, Rd, Chr, Rd^Edt, Hhd, Rd^Edt, Gd^Edt, Gd^Fdw, Gd, Gd^Fdw, Gd^Fdw, Wwg, Wwg, Gd^Es, Gs^Es, Gs^Es, Gd, Gd, Gll, Re^Es, Gll^Edt, Gll^Edt, Re, Ko, Re, Re^Edt, Gll^Vo, Gll, Hhd, Rb, Ss, Rb, Rb, Gd, Re^Es, Re^Es, Gs, Gs, Gd, Rd, Rd^Es, Rd, Rd^Es, Gd, Gs, Gs, Gll^Fp, Gll^Fp, Gll^Fp
Gd, Gd, Rd, Rd^Es, Rd^Es, Gd^Es, Re, Gd, Gs, Gs, Gd, Gd^Es, Re, Re, Gs, Gs^Edt, Gd, Gd^Fdw, Aa^Esa, Aa^Esa, Mm, Mm, Mm^Xm, Khr, Hhd, Gd^Fdw, Gll^Fmw, Gd, Gd, Gll^Fmw, Wwf, Wwf, Gd, Wwg, Wwg, Gd, Rb, Gd, Re, Hhd, Re, Gll^Vo, Gll^Edt, Re, Gll^Es, Re, Re^Edt, Re^Edt, Cer^Es, Rb, Sm, Rb, Sm, Re^Vo, Gs^Es, Gs^Es, Hhd, Gd^Fp, Hhd, Gs, Rd, Rd^Dr, Rd^Es, Gd^Es, Gs, Gd, Gd, Gs, Gs
Aa, Gd, Aa, Gd, Gd^Es, Re, Chr, Re, Re^Vo, Gd, Gd, Re, Gd, Gd, Aa, Gs, Hhd, Hhd, Hhd, Ha^Fdw, Mm, Mm, Mm, Mm^Xm, Mm^Xm, Hhd, Hhd, Hhd, Hhd^Edt, Gd^Fdw, Wwf, Gd, Gs, Wwrg, Wwg, Gd, Rb, Rb, Sm, Co^Dr, Hhd, Gll, Gll^Edt, Gll^Vo, Gll^Es, Gll^Es, Re, Re, Rb, Ss, Rb, Rb, Sm, Gs^Es, Gs, Gs, Hhd, Hhd^Fp, Gd^Fp, Gs, Gs, Rd, Rd, Gs^Es, Gd, Gd, Gd, Gd, Gs
Ha, Aa, Gd^Esa, Gs, Gs^Es, Re^Es, Re^Es, Hhd, Hhd, Hhd, Gd, Re, Re^Es, Gd, Hhd, Gd^Fmw, Hhd, Hhd^Fdw, Hhd, Gd^Fmw, Gll^Fmw, Hhd^Fdw, Hhd, Mm, Mm, Mm, Mm, Chr^Es, Khw, Ss, Chr, Gs^Es, Gs^Es, Gd^Es, Re^Es, Wwg^Bp/, Wwg, Wwg, Wwg, Sm, Ss, Rb, Hhd, Rb^Es, Rb^Es, Gll^Vo, Hhd, Co^Dr, Sm, Ss^Bp\, Rb, Re, Re, Gs, Re, Gs, Rd, Hhd, Rd, Rd, Hhd, Hhd, Gd^Fp, Gd, Gd, Gs, Gs, Gs, Gs
Hhd, Hhd, Re^Vo, Gs, Re, Re, Gd, Gd^Fmw, Hhd^Fdw, Hhd^Fmw, Hhd, Hhd, Re, Hhd, Gd^Vo, Hhd, Gd, Aa, Gd^Esa, Gd^Fmw, Gd^Fmw, Hhd^Fmw, Gd^Fmw, Ha, Aa, Mm, Wwf^Edt, Chr^Edt, Wwf^Edt, Ss, Hhd, Rd, Rd, Rd^Es, Gs^Es, Gd, Rb, Rb, Rb, Wo, Wo, Sm, Sm, Cer^Es, Sm, Rb, Sm, Ss, Wo, Wwg, Wwg, Sm, Gd, Re, Gd, Re, Rd^Es, Rd^Dr, Rd, Re^Vo, Gd, Hhd, Gs, Gs, Gd, Gs, Gs, Gs^Cov, Gs
Hhd, Hhd, Gd^Fmw, Re^Es, Gs, Re, Gd, Hhd, Gd^Es, Hhd, Gd^Es, Gd, Re, Gd, Gd, Gd^Es, Rd^Es, Gd, Gs, Gd, Gs, Gd, Gd^Esa, Aa, Gd^Fmw, Hhd^Esa, Re^Vo, Wwf^Edt, Hhd, Hhd, Gd^Es, Gs^Es, Rd^Dr, Rd, Gs^Vo, Gs, Gd, Gd, Gd, Wwrg, Wwf, Wwg, Rb, Sm, Rb, Sm, Rb, Wwg, Wwrg, Wwg, Wwg, Sm, Gd^Es, Gd, Hhd, Rd, Gs^Es, Rd^Es, Gs, Re, Re, 1 Re, Re, Gs, Re, Gs, Re^Cov, Gs^Cov, Re
Hhd, Hhd, Aa, Aa^Esa, Aa, Re, Re, Re, Re^Es, Re^Es, Re^Es, Gd, Re^Edt, Re, Co, Rd, Rd^Dr, Rd^Es, Gs^Es, Gs, Re, Re, Re, Re, Re, Re, Re^Es, Gd, Hhd, Hhd, Gd, Gd^Es, Rd, Rd, Gs, Gs, Hhd, Gll^Fmw, Hhd^Fp, Gd, Wwf, Rb, Gd, Rb, Gd, Rb, Gd, Rb, Rd^Es, Rb, Ss, Wwg, Wwrg, Gd^Fp, Hhd, Hhd, Hhd^Fp, Gs, Gs, Gs, Gs, Re, Gs, Re, Gs, Re, Gs^Cov, 2 Re^Kov, Gs
Hhd, Hhd, Hhd^Fmw, Hhd, Gd^Fmw, Gs, Re, Hhd, Hhd, Hhd, Hhd, Re, Hhd, Co, Co, Co, Re, Gs, Re^Es, Re, Hhd, Hhd, Mm, Hhd, Gd^Fmw, Gs, Re, Co, Re, Gs, Gs^Es, Rd^Es, Re, Gd^Es, Hhd, Gd^Fp, Hhd, Hhd, Hhd^Fp, Gd^Fp, Wwf, Gd, Gd, Gd, Re^Vo, Gd, Rd^Es, Rd, Rd^Dr, Rd^Es, Ss, Wwg, Wwg, Gd, Gd^Fp, Gd^Fp, Hhd, Hhd, Gd, Gs, Rd, Gs, Rd, Gd, Gd, Gs, Gs, Gs^Cov, Gs
Hhd^Fmw, Hhd^Fmw, Gd^Fmw, Gd^Fmw, Gd^Fmw, Gll^Fmw, Gd^Es, Re^Vo, Hhd, Hhd, Hhd^Fmw, Hhd, Hhd, Re, Re^Es, 5 Ko, Re, Gd, Re, Gd^Vo, Mm, Mm^Xm, Mm, Hhd^Fmw, Gll^Fmw, Gs, Rd^Es, Rd, Rd, Re, Re^Vo, Re, Hhd, Gd^Esa, Aa^Esa, Hhd, Mm, Hhd, Hhd^Fp, Hhd^Fp, Wwf, Hhd, Gd, Re, Rd, Rd, Gd^Es, Rd^Es, Rd, Ss, Ss, Ss, Wwg, Gd, Gd^Fp, Gd^Fp, Gll^Fmw, Gd, Gs, Rd, Rd^Dr, Rd, Gs, Gd, Gd, Gd, Gs, Gs^Cov, Gs
Hhd^Fmw, Hhd^Fmw, Gd^Fmw, Hhd, Hhd, Hhd, Gd, Re, Hhd^Fmw, Hhd, Hhd^Fmw, Hhd^Fdw, Hhd, Hhd, Gd^Es, Re^Es, Gd, Re, Gd, Hhd, Mm, Mm, Ha^Fdw, Hhd^Fmw, Hhd, Gd, Gd^Es, Rd^Dr, Rd^Es, Gd, Gd^Fp, Hhd, Gd^Fp, Aa, Ha, Mm, Mm, Aa^Esa, Hhd^Fp, Wwf, Hhd, Hhd, Gd^Es, Gd, Gd, Gd^Es, Gll^Fmw, Gd^Fp, Hhd^Fp, Gd^Fp, Gll^Fmw, Ss, Wwg, Wwrg, Wwg, Gs, Gs, Gd, Gs, Rd^Es, Rd^Es, Hhd, Hhd, Gd^Fp, Hhd, Gs, Gd^Fp, Gs, Gs
Hhd^Fmw, Hhd^Fmw, Hhd^Fmw, Gd^Fmw, Hhd, Hhd, Hhd, Hhd, Hhd^Fmw, Hhd^Fdw, Hhd^Fmw, Hhd^Fmw, Hhd^Fmw, Hhd, Gd, Gd^Es, Gd, Re, Gd, Gd^Esa, Aa, Aa^Esa, Aa^Esa, Gd^Fmw, Aa, Gd, Gd^Esa, Rd^Es, Gd, Gll, Gll^Fmw, Gd^Fp, Gd^Fp, Gd^Fp, Hhd, Mm, Mm, Mm, Hhd, Hhd, Gd^Es, Gd^Es, Gd, Gd, Gd, Gd, Gd^Fp, Gd^Fp, Hhd, Gd^Fp, Gd^Fp, Gd, Gd, Wwg, Wwg, Wwg, Gd, Gd, Gd, Rd^Es, Gs^Es, Gd^Fp, Hhd, Hhd^Fp, Hhd, Hhd^Fp, Hhd, Gll^Fmw, Gll^Fmw
Hhd^Fmw, Hhd^Fmw, Gd^Fmw, Hhd^Fmw, Hhd^Fmw, Hhd^Fmw, Hhd, Hhd^Fmw, Hhd^Fmw, Hhd^Fmw, Hhd^Fmw, Hhd^Fmw, Hhd^Fmw, Hhd, Hhd, Hhd, Gd, Re, Re, Gd, Aa, Aa, Aa, Aa, Gd, Gd, Gd, Gd, Rb, Gd, Gll^Fp, Gd^Fp, Gd^Fp, Hhd, Hhd, Mm, Mm, Mm, Hhd^Fp, Hhd, Gd, Gd^Es, Gd, Gd^Es, Gd, Hhd, Hhd, Hhd, Hhd^Fp, Hhd, Hhd^Fp, Gd^Fp, Gd, Gd, Wwg, Wwg, Wwg, Gd, Gs, Gs, Gs, Hhd, Gd, Hhd, Hhd, Hhd, Hhd, Hhd, Gs
