Xu, Xu, Xu, Xu, Xu, Xu, Uh, Uu, Uu^Edb, Uu, Xu, Xu, Xu, Xu, Xu, Xu, Uh, Xu, Xu, Xu, Tb, Uu, Uu^Em, Xu, Xu, Xu, Xu, Xu, Wwg, Xu, Xu, Xu, Xu, Uh, Uu^Em, Uu, Xu, Xu, Xu, Xu, Xu, Xu, Xu, Xu
Xu, Xu, Xu, Xu, Xu, Xu, Xu, Uu^Edb, Uu^Edb, Uu^Em, Tb, Xu, Uu^Em, Xu, Uu^Em, Uu^Em, Xu, Uu, Xu, Xu, Xu, Uu^Em, Uh, Xu, Xu, Xu, Tb, Xu, Wwg, Tb, Xu, Xu, Tb, Uh, Tb, Uh, Xu, Xu, Xu, Xu, Wwg, Xu, Wog, Wog
Xu, Xu, Xu, Xu, Xu, Xu, Xu, Uh, Uh, Uu^Em, Uu^Em, Tb, Xu, Uu^Em, Xu, Xu, Xu, 3 Uu^Edb, Uh, Xu, Tb, Uu^Em, Uu^Em, Xu, Xu, Xu, Uu^Em, Wwg, Tb, Uu^Em, Xu, Xu, Uu^Em, Uu^Em, Tb, Xu, Xu, Xu, Wwg, Wog, Wog, Wog, Wog, Wog
Uu, Xu, Uu, Xu, Uu, Xu, Xu, Xu, Xu, Tb, Wwg, Uu^Em, Uh, Xu, Xu, Xu, Tb, Uu^Em, Uh, Xu, Uh, Uu^Em, Tb, Uh, Xu, Uh, Uu^Em, Wwg, Uu^Em, Xu, Uh, Uh, Uu^Em, Uh, Xu, Xu, Xu, Xu, Wog, Wog, Xu, Wwg, Xu, Xu
Uu, Uu, Uu, Uu^Em, Uu^Em, Xu, Tb, Xu, Xu, Xu, Uu^Em, Wwg^Edb, Wwg, Tb, Xu, Xu, Uh, Uu^Em, Uu^Em, Uu^Edb, Uu, Uu, Uu, Uu, Wwg^Edb, Wwg^Edb, Wwg^Edb, Wwg^Edb, Wog, Uu, Wog, Uu, Uu, Xu, Xu, Wwg, Wog, Wog, Wog, Wwg, Xu, Xu, Xu, Xu
Xu, Xu, Tb, Uu^Em, Uu^Em, Uu^Em, Uu^Em, Xu, Xu, Uh, Uu^Edb, Wwg, Wwg, Uu^Em, Xu, Xu, Xu, Uu, Wwg^Edb, Wwg^Edb, Wwg, Wog, Wog, Wwg, Wog, Wwg^Edb, Wwg, Wwg^Edb, Wwg, Wog, Wog^Edb, Wwg^Edb, Wwg^Edb, Wwg, Wwg^Edb, Wog, Wog^Edb, Wog, Uh, Xu, Xu, Xu, Xu, Xu
Xu, Xu, Xu, Xu, Xu, Tb, Tb, Uu^Em, Uu^Em, Xu, Uu^Edb, Uu^Edb, Wog, Wwg, Wog, Wog, Wog, Wwg^Edb, Wwg, Wwg^Edb, Wwg^Es, Wwg, Wwg^Es, Wog^Es, Wog^Es, Kte, Uh, Uu^Bs|, Uu^Bs|, Wog, Uu^Bs|, Wwg^Es, Wwg^Es, Wwg^Es, Wog, Wog, Wog^Edb, Wwg^Edb, Xu, Uu, Uu, Xu, Xu, Xu
Xu, Xu, Xu, Xu, Xu, Tb, Xu, Uu^Em, Wog^Edb, Wog, Wwg^Edb, Wog, Wwg^Edb, Wwg^Edb, Wwg^Es, Wog, Wog^Es, Wwg, Uu^Bs|, Uu^Bs|, Uu^Bs|, Uu^Bs|, Uu^Bs|, Uh, Uu^Bs|, Uu^Bs|, Uu^Bs|, Uu^Bs|, Uh, Uu^Bs|, Uu^Bs|, Uu^Bs|, Uu^Bs|, Uh, Uh, Wog, Wog, Wog^Edb, Xu, Xu, Uu, Xu, Xu, Xu
Xu, Xu, Xu, Xu, Uu, Xu, Wog^Edb, Wog^Edb, Wwg^Edb, Wwg^Edb, Wwg, Wwg^Es, Uu^Bs|, Wwg^Es, Uu^Bs|, Uu^Bs|, Uh, Kte, Uu^Bs|, Uu^Bs|, Uh, Uu^Bs|, Uh, Uu^Bs|, Uu^Bs|, Uu^Bs|, Uu^Bs|, Uh, Uh, Kte, Uu^Bs|, Uu^Bs|, Uu^Bs|, Uh, Cte, Wog, Wog, Uh, Uu, Uu, Xu, Uu, Uu, Uu
Xu, Xu, Uu, Uu, Xu, Uh, Wog, Wwg, Cte, Uh, Uu^Bs|, Uu^Bs|, Uh, Uh, Uu^Bs|, Uu^Bs|, Uu^Bs|, Uu^Bs|, Uu^Bs|, Uu^Bs|, Uu^Bs|, Kte, Uh, 2 Uu^Bs|, Uu^Bs|, Uu^Bs|, Uu^Bs|, Uu^Bs|, Uu^Bs|, Uu^Bs|, Uu^Bs|, Uu^Bs|, Wog^Es, Uu^Bs|, Wog, Wog, Wog, Xu, Xu, Xu, Xu, Xu, Xu, Xu
Uu, Xu, Uu, Xu, Xu, Xu, Wog, Wwg, Uh, Uu^Bs|, Uu^Bs|, Uu^Bs|, Uu^Bs|, Kte, Uu^Bs|, Uu^Bs|, Uu^Bs|, Uu^Bs|, Uu^Bs|, Uu^Bs|, Uu^Bs|, Uu^Bs|, Uu^Bs|, Uu^Bs|, Uh, Kte, Wog, Uh, Wog, Wog, Wog, Wog, Wog, Wog, Wog, Wog, Uu, Xu, Xu, Xu, Xu, Xu, Xu, Xu
Xu, Uu, Xu, Uu, Uh, Xu, Wog, Wog, Wog, Uh, Wog, Uu^Bs|, Uu^Bs|, Uu^Bs|, Uu^Bs|, Uu^Bs|, Uh, Uh, Wog, Uu^Bs|, Wog, Uu^Bs|, Wwf^Es, Uu^Bs|, Wwf^Es, Wwrg, Wog, Wog, Wog, Wog, Wog, Wog, Uu, Wog, Xu, Uu, Uu, Xu, Xu, Xu, Xu, Xu, Xu, Xu
Xu, Xu, Xu, Xu, Xu, Wog, Wog, Wog, Wog, Wog, Wog, Wog, Wog, Wog, Wog, Uu^Bs|, Wog, Kte, Wog, Wog, Wwrg, Wwrg, Wwrg, Wwf^Es, Wwf, Wwf, Wwrg, Wog, Cte, Xu, Xu, Xu, Xu, Xu, Xu, Uu, Xu, Uu, Xu, Xu, Xu, Xu, Xu, Xu
Wog, Xu, Wog, Xu, Wog, Wog, Wog, Wog, Wog, Wog, Uu, Wog, Wog, Wog, Wog, Wog, Wog, Wog, Wo, Wog, Xu, Wwrg, Cte, Wwf, Rb, Wwf, Cte, Xu, Cte, Cte, 1 Kte, Xu, Xu, Xu, Xu, Xu, Xu, Xu, Xu, Xu, Xu, Xu, Xu, Xu
Wog, Wog, Wog, Wog, Wog, Wog, Wog, Xu, Xu, Xu, Uh, Uu, Uu, Xu, Xu, Wog, Uu, Wog, Xu, Xu, Xu, Xu, Xu, Uu, Uu, Rb, Uu, Cte, Cte, Cte, Xu, Xu, Xu, Xu, Xu, Xu, Xu, Xu, Xu, Xu, Xu, Xu, Xu, Xu
Wog, Wog, Xu, Xu, Xu, Xu, Xu, Xu, Xu, Xu, Uh, Uh, Xu, Xu, Uh, Uh, Uh, Uu, Xu, Xu, Xu, Xu, Xu, Xu, Xu, Rb, Rb, Uu, Xu, Xu, Xu, Xu, Xu, Xu, Xu, Xu, Xu, Xu, Xu, Xu, Xu, Xu, Xu, Xu
Xu, Xu, Xu, Xu, Xu, Xu, Xu, Xu, Xu, Xu, Xu, Xu, Xu, Xu, Xu, Xu, Xu, Xu, Xu, Xu, Xu, Xu, Xu, Xu, Xu, Uu, Uu, Uu, Uu, Xu, Xu, Xu, Xu, Xu, Xu, Xu, Xu, Xu, Xu, Xu, Xu, Xu, Xu, Xu
Xu, Xu, Xu, Xu, Xu, Xu, Xu, Xu, Xu, Xu, Xu, Xu, Xu, Xu, Xu, Xu, Xu, Xu, Xu, Xu, Xu, Xu, Xu, Xu, Xu, Xu, Uu, Rb, Uu, Xu, Xu, Xu, Xu, Xu, Xu, Xu, Xu, Xu, Xu, Xu, Xu, Xu, Xu, Xu
