Xu, Xu, Xu, Xu, Xu, Xu, Xu, Xu, Xu, Xu, Xu, Xu, Wog, Wog, Wog, Xu, Xu, Xu, Xu, Xu, Xu, Xu, Xu, Xu, Xu, Xu, Xu, Xu, Xu, Xu, Xu, Xu, Xu, Xu, Xu, Xu, Xu, Xu, Xu, Xu, Xu, Xu, Xu, Xu, Xu, Xu
Xu, Xu, Xu, Xu, Xu, Xu, Xu, Xu, Xu, Xu, Xu, Xu, Wog, Wog, Wog, Xu, Xu, Xu, Xu, Xu, Xu, Xu, Xu, Xu, Xu, Xu, Xu, Xu, Xu, Xu, Xu, Xu, Xu, Xu, Xu, Xu, Xu, Xu, Xu, Xu, Xu, Xu, Xu, Xu, Xu, Xu
Xu, Xu, Xu, Xu, Xu, Xu, Uu, Uu, Xu, Xu, Xu, Xu, Xu, Wog, Wog, Wog, Wog, Xu, Xu, Xu, Xu, Xu, Xu, Xu, Xu, Xu, Wog, Xu, Xu, Xu, Wog, Xu, Xu, Xu, Wog, Xu, Xu, Wog, Xu, Xu, Wog, Wog, Wog, Xu, Xu, Xu
Xu, Xu, Xu, Xu, Xu, Xu, Xu, Uh, Uu, Uh^Vht, Xu, Xu, Xu, Wog, Wog, Wog, Wog, Xu, Xu, Xu, Xu, Wog, Wog, Xu, Xu, Wog, Xu, Xu, Xu, Wog, Xu, Wog, Xu, Xu, Wog, Xu, Xu, Wog, Xu, Xu, Wog, Xu, Xu, Wog, Xu, Xu
Xu, Xu, Xu, Xu, Uh^Vht, Xu, Xu, Uh^Vht, Uh, Uu, Uu^Vht, 5 Kte, Cte, Cte, Cte, Wog, Wog, Wog, Xu, Xu, Xu, Wog, Xu, Wog, Xu, Wog, Wog, Xu, Xu, Wog, Wog, Wog, Xu, Xu, Wog, Xu, Xu, Wog, Xu, Xu, Wog, Xu, Wog, Xu, Xu, Xu
Xu, Xu, Xu, Uh, Uh, Uh, Uu, Uu, Uu, Uu, Cte, Cte, Wog, Wog, Wog, Wog, Wog, Wog, Wog, Xu, Xu, Wog, Xu, Wog, Xu, Wog, Xu, Xu, Xu, Wog, Xu, Wog, Xu, Xu, Wog, Xu, Xu, Wog, Xu, Xu, Wog, Xu, Xu, Wog, Xu, Xu
Xu, Xu, Xu, Xu, Uh, Uh^Vht, Xu, Xu, Uh^Vht, Uu, Cte, Wog, Wog, Wog, Wog, Wog, Wog, Wog, Wog, Xu, Xu, Wog, Wog, Wog, Xu, Wog, Wog, Xu, Xu, Wog, Wog, Wog, Xu, Xu, Xu, Wog, Wog, Wog, Xu, Xu, Xu, Wog, Wog, Wog, Xu, Xu
Xu, Xu, Xu, Xu, Xu, Uh, Uh, Xu, Xu, Uu, Uu, Wog, Wog, Wog, Wog, Wog, Wog, Wog, Wog, Wog, Xu, Wog, Xu, Xu, Xu, Wog, Xu, Xu, Xu, Wog, Xu, Xu, Xu, Xu, Xu, Xu, Xu, Xu, Xu, Xu, Xu, Xu, Xu, Xu, Xu, Xu
Xu, Xu, Xu, Xu, Xu, Uh^Vht, Xu, Xu, Xu, Uh^Vht, Xu, Uu^Vht, Xu, Wog, Wog, Wog, Wog, Wog, Wog, Xu, Xu, Xu, Xu, Xu, Xu, Xu, Xu, Xu, Xu, Xu, Xu, Xu, Xu, Xu, Xu, Xu, Xu, Xu, Xu, Xu, Xu, Xu, Xu, Xu, Xu, Xu
Xu, Xu, Xu, Xu, Xu, Xu, Xu, Xu, Xu, Xu, Xu, Xu, Xu, Wog, Xu, Wog, Xu, Xu, Xu, Xu, Wwg, Xu, Xu, Xu, Xu, Xu, Xu, Xu, Xu, Xu, Xu, Xu, Cte, Cte, Uu, Uu^Vu, Uu, Uu^Vu, Uu, Xu, Uu^Vu, Xu, Uu, Xu, Uu, Xu
Xu, Xu, Xu, Xu, Xu, Xu, Xu, Xu, Xu, Xu, Xu, Xu, Xu, Xu, Xu, Xu, Wwg, Wwg, Wwg, Wwg, Uh^Vov, Wwg, Wwg, Xu, Wwg, Xu, Xu, Xu, Xu, Xu, Xu, 1 Kte, Cte, Cte, Ur, Uu, Ur, Uu, Ur, Uu, Ur, Uu, Ur, Ur, Ur, Ur
Xu, Xu, Xu, Xu, Xu, Xu, Xu, Xu, Xu, Xu, Uh^Vht, Xu, Uh, Xu, Xu, Wwg, Uh^Es, Ur^Es, Ur^Es, Ur^Es, Ur^Es, Wwg, Ur^Es, Wwg, Rb^Es, Wwg, Xu, Xu, Xu, Xu, Cte, Cte, Uu^Vu, Uu, Ur, Ur, Uu, Ur, Uu, Ur, Uu, Ur, Uu, Ur, Uu, Uu
Xu, Xu, Xu, Xu, Xu, Xu, Xu, Xu, Uh, Xu, Uu, Tb, Uu, Xu, Uu, Wwg^Edb, Rb^Es, Kte^Bs|, Ur^Es, Ur^Es, Ur^Es, Ur^Es, Ur^Es, Kte^Bs|, Uh^Es, Wwg, Wwf, Wwf^Es, Wwf^Es, Wwf, Ur, Uu, Uu, 2 Ur, Uu, Uu, Xu, Uu, Xu, Uu^Vu, Xu, Xu, Xu, Xu, Xu, Xu
Xu, Xu, Xu, Xu, Xu, Xu, Xu, Xu, Uh, Uh, Ur, Ur, Xu, Uu, Uu, Wwg^Edb, Wwg^Edb, Uh^Es, Wwg^Edb, Ur^Es, Uh^Vov, Ur^Es, Ur^Es, Ur^Es, Ur^Es, Wwf, Wwf, Wwf^Es, Wwf^Es, Wwf, Uu^Es, Ur, Ur, Ur, Uu^Vu, Xu, Xu, Xu, Xu, Xu, Xu, Xu, Xu, Xu, Xu, Xu
Xu, Xu, Xu, Xu, Xu, Uh, Uh^Vht, Uh, Uh, Uu, Rb, Uh, Xu, Xu, Uh, Uu, Uu, Wwg^Edb, Uu, Wwg, Rb^Es, Ur^Es, Ur^Es, Ur^Es, Ur^Es, Rb^Es, Wwf, Wwf, Wwf, Wwf, Ur^Es, Ur, Ur, Uu, Uu, Xu, Xu, Xu, Xu, Xu, Xu, Xu, Xu, Xu, Xu, Xu
Xu, Xu, Xu, Xu, Xu, Uh, Tb, Uh, Uu, Rb, Xu, Xu, Xu, Xu, Xu, Uh, Rb, Uu, Uu, Wwg^Edb, Wwg^Edb, Kte^Bs|, Ur^Es, Ur^Es, Ur^Es, Uh^Es, Uh^Vov, Wwf, Wwf, Wwf^Es, Wwf^Es, Uu, Wwg^Es, Ur^Es, Xu, Xu, Xu, Xu, Xu, Xu, Xu, Xu, Xu, Xu, Xu, Xu
Xu, Xu, Xu, Xu, Uh, Tb, Uu, Uu, Uu, Uu^Vht, Xu, Xu, Uh, Xu, Uu, Uh, Ur, Rb, Uu, Wwg^Edb, Wwg^Edb, Uh^Es, Uh^Vov, Ur^Es, Ur^Es, Ur^Es, Ur^Es, Wwf, Wwf, Wwg, Wwg, Wwg^Es, Wwg^Es, Wwf^Es, Xu, Xu, Xu, Xu, Xu, Xu, Xu, Xu, Xu, Xu, Xu, Xu
Xu, Xu, Xu, Uh^Vht, Uu, Ur, Cer, Cer, Xu, Xu, Xu, Uh^Vht, Ur, Xu, Tb, Uu, Uh, Uu, Xu, Uu^Edb, Uu^Edb, Wwg^Edb, Wwg^Edb, Ur^Es, Ur^Es, Kte^Bs|, Ur^Es, Ur^Es, Uh^Vov, Wwg^Es, Wwg, Wwf, Wwf, Wwf, Xu, Xu, Xu, Xu, Xu, Xu, Xu, Xu, Xu, Xu, Xu, Xu
Xu, Xu, Xu, Uh, Uu^Vht, Ur, Cer, Xu, Xu, Uh, Tb^Tf, Rb, Rb, Rb, Uh, Xu, Xu, Xu, Xu, Uh, Uu, Wwg^Edb, Wwg^Edb, Uh^Es, Uh^Vov, Ur^Es, Ur^Es, Ur^Es, Uh, Wwg, Wwf, Wwf, Xu, Xu, Xu, Xu, Xu, Xu, Xu, Xu, Xu, Xu, Xu, Xu, Xu, Xu
Uu, Tb, Rb, Uu, Rb, Rb, Cer, Cer, Cer, Tb, Xu, Uh, Xu, Xu, Xu, Xu, Xu, Xu, Xu, Uh, Uh, Uu^Edb, Wwg^Edb, Uh^Es, Uh^Es, Ur^Es, Ur^Es, Ur^Es, Ur^Es, Kte^Bs|, Wwf, Wwf, Wwg, Xu, Xu, Xu, Xu, Xu, Xu, Xu, Xu, Xu, Xu, Xu, Xu, Xu
Uh, Uu, Uh, Ur, Tb^Tf, Uu, Cer, 3 Kea, Cer, Xu, Xu, Xu, Uh, Xu, Uh, Uh, Uh, Uh, Rb, Xu, Uu, Uu^Edb, Wwg^Edb, Wwg^Edb, Rb^Es, Ur^Es, Ur^Es, Ur^Es, Ur^Es, Ur^Es, Rb^Es, Wwf, Wwg, Xu, Xu, Xu, Xu, Xu, Xu, Xu, Xu, Xu, Xu, Xu, Xu, Xu
Uh, Uh, Xu, Uh^Vht, Uu, Uu, Xu, Cer, Cer, Xu, Xu, Xu, Tb, Uu^Vht, Uu, Ur, Uu, Tb^Tf, Uu, Rb, Uh, Uu, Uu, Wwg^Edb, Wwg^Edb, Kte^Bs|, Uh^Es, Ur^Es, Ur^Es, Ur^Es, Uh^Vov, Wwg, Wwg, Wwg, Xu, Xu, Xu, Xu, Xu, Xu, Xu, Xu, Xu, Xu, Xu, Xu
Xu, Xu, Xu, Xu, Tb, Uu^Vht, Xu, Xu, Xu, Cer, Cer, Cer, Xu, Uh, Uh, Rb, Xu, Uh, Xu, Uh, Ur, Uh, Uu, Uu, Wwg^Edb, Wwg^Edb, Uu^Bs|, Uh^Vov, Ur^Es, Uh^Es, Uh^Es, Uu^Bs|, Wwg^Edb, Wwg, Xu, Xu, Xu, Xu, Xu, Xu, Xu, Xu, Xu, Xu, Xu, Xu
Xu, Xu, Xu, Xu, Xu, Uu, Uh, Xu, Uh, Xu, Xu, Xu, Xu, Xu, Xu, Xu, Rb^Vht, Xu, Uu, Uu, Xu, Uu, Rb, Uu, Uu, Wwg^Edb, Wwg^Edb, Rb^Es, Wwg^Edb, Kte^Bs|, Uh^Vov, Wwg, Wwg^Edb, Xu, Xu, Xu, Xu, Xu, Xu, Xu, Xu, Xu, Xu, Xu, Xu, Xu
Xu, Xu, Xu, Uh^Vht, Uh, Uu, Uu, Uh, Xu, Xu, Xu, Xu, Uu, Xu, Tb, Xu, Rb, Ur, Uu, Xu, Uh, Tb, Rb, Uu, Xu, Xu, Uh, Wwg^Edb, Wwg^Edb, Rb^Es, Wwg^Edb, Wwg, Xu, Xu, Xu, Xu, Xu, Xu, Xu, Xu, Xu, Xu, Xu, Xu, Xu, Xu
Xu, Xu, Xu, Uh, Uh, Uh^Vht, Uh, Uu, Uu^Vht, Xu, Xu, Xu, Cer, Rb, Xu, Uu, Xu, Xu, Xu, Uh, Uh, Ur, Uh, Uh, Xu, Xu, Uu, Uu, Uu, Wwg^Edb, Xu, Xu, Wo, Wo, Wog, Xu, Wog, Xu, Xu, Xu, Xu, Xu, Xu, Xu, Xu, Xu
Xu, Xu, Xu, Xu, Xu, Uh, Uh, Uu, Uu, Tb^Tf, Tb, Xu, Cer, Xu, Xu, Xu, Uh, Uh^Vht, Uh, Tb, Uu, Rb, Uh^Vht, Xu, Xu, Uu, Ur, Uu, Uh, Xu, Xu, Wo, Wog, Wog, Wog, Wog, Wog, Wog, Wog, Wog, Wog, Wog, Wog, Xu, Wog, Wog
Xu, Xu, Xu, Xu, Xu, Uh^Vht, Uh, Uh, Uh, Uu, Uu, Uu, Uu, Cer, Cer, Uu, Rb, Uu, Ur, Ur, Xu, Xu, Xu, Xu, Uh, Uh, Uu, Uh, Xu, Xu, Xu, Wo, Wog, Wog, Wog, Wog, Wog, Wog, Wog, Wog, Wog, Wog, Wog, Wog, Wog, Wog
Xu, Xu, Xu, Xu, Xu, Xu, Uh, Uh, Uh, Uh^Vht, Tb, Uu, Ur, Cer, 4 Kea, Cer, Rb, Rb, Uu, Xu, Tb^Tf, Xu, Ur, Tb, Uh, Uu, Uh, Uh, Xu, Xu, Xu, Xu, Wog, Wog, Wog, Wog, Wog, Wog, Wog, Wog, Xu, Xu, Xu, Wog, Wog, Wog
Xu, Xu, Xu, Xu, Xu, Xu, Uh^Vht, Uh, Uh, Uh, Xu, Uu, Uu, Cer, Cer, Cer, Cer, Uu, Cer, Uu, Uh, Uu, Uh, Uu, Uh, Uh, Uh, Uh^Vht, Xu, Xu, Uh^Vht, Xu, Xu, Wog, Wog, Wog, Wog, Wog, Wog, Cte, Uu, Uh^Vht, Xu, Wog, Wog, Wog
Xu, Xu, Xu, Xu, Xu, Xu, Xu, Xu, Xu, Xu, Xu, Uu, Uu^Vht, Ur, Uu, Tb, Uu, Cer, Xu, Xu, Xu, Uh^Vht, Xu, Xu, Tb^Tf, Uh, Uh, Xu, Xu, Uh, Uh, Xu, Xu, Wog, Wog, Wog, Wog, Wog, Cte, Cte, Uu, Uu, Xu, Xu, Xu, Xu
Xu, Xu, Xu, Xu, Xu, Xu, Xu, Xu, Xu, Xu, Xu, Uh, Uh, Ur, Uh, Uu^Vht, Tb, Uh, Uh, Xu, Xu, Xu, Xu, Xu, Xu, Xu, Xu, Xu, Uh^Vht, Uh, Uh, Xu, Xu, Wog, Wog, Wog, Wog, Wog, Cte, Uu, Uh, Xu, Xu, Uh^Vht, Uh, Xu
Xu, Xu, Xu, Xu, Xu, Xu, Xu, Xu, Xu, Xu, Xu, Uh, Xu, Uh, Uh^Vht, Uh, Uh, Xu, Xu, Xu, Xu, Xu, Xu, Xu, Xu, Xu, Xu, Uh, Uh, Uh, Uh, Uh^Vht, Xu, Cte, Cte, Cte, Cte, Cte, 6 Kte, Uu, Uu^Vht, Uh, Xu, Uh, Uu, Uu
Xu, Xu, Xu, Xu, Xu, Xu, Xu, Xu, Xu, Xu, Xu, Xu, Xu, Xu, Xu, Xu, Xu, Xu, Xu, Xu, Xu, Xu, Xu, Xu, Xu, Xu, Xu, Uh^Vht, Uh, Uh, Uh^Vht, Uh, Uh, Xu, Uh, Uu, Uu, Uu, Uu, Uu, Uu, Uu, Uu, Uu, Uu, Uu
Xu, Xu, Xu, Xu, Xu, Xu, Xu, Xu, Xu, Xu, Xu, Xu, Xu, Xu, Xu, Xu, Xu, Xu, Xu, Xu, Xu, Xu, Xu, Xu, Xu, Xu, Xu, Uh, Xu, Uh, Xu, Uh, Uh^Vht, Uh, Xu, Uh^Vht, Xu, Xu, Xu, Uh, Uh, Uu, Xu, Uu, Uh, Uu
Xu, Xu, Xu, Xu, Xu, Xu, Xu, Xu, Xu, Xu, Xu, Xu, Xu, Xu, Xu, Xu, Xu, Xu, Xu, Xu, Xu, Xu, Xu, Xu, Xu, Xu, Xu, Xu, Xu, Xu, Xu, Xu, Xu, Xu, Xu, Xu, Xu, Xu, Xu, Uh^Vht, Xu, Uh, Xu, Uh^Vht, Xu, Xu
Xu, Xu, Xu, Xu, Xu, Xu, Xu, Xu, Xu, Xu, Xu, Xu, Xu, Xu, Xu, Xu, Xu, Xu, Xu, Xu, Xu, Xu, Xu, Xu, Xu, Xu, Xu, Xu, Xu, Xu, Xu, Xu, Xu, Xu, Xu, Xu, Xu, Xu, Xu, Xu, Xu, Xu, Xu, Xu, Xu, Xu
Xu, Xu, Xu, Xu, Xu, Xu, Xu, Xu, Xu, Xu, Xu, Xu, Xu, Xu, Xu, Xu, Xu, Xu, Xu, Xu, Xu, Xu, Xu, Xu, Xu, Xu, Xu, Xu, Xu, Xu, Xu, Xu, Xu, Xu, Xu, Xu, Xu, Xu, Xu, Xu, Xu, Xu, Xu, Xu, Xu, Xu
Xu, Xu, Xu, Xu, Xu, Xu, Xu, Xu, Xu, Xu, Xu, Xu, Xu, Xu, Xu, Xu, Xu, Xu, Xu, Xu, Xu, Xu, Xu, Xu, Xu, Xu, Xu, Xu, Xu, Xu, Xu, Xu, Xu, Xu, Xu, Xu, Xu, Xu, Xu, Xu, Xu, Xu, Xu, Xu, Xu, Xu
Xu, Xu, Xu, Xu, Xu, Xu, Xu, Xu, Xu, Xu, Xu, Xu, Xu, Xu, Xu, Xu, Xu, Xu, Xu, Xu, Xu, Xu, Xu, Xu, Xu, Xu, Xu, Xu, Xu, Xu, Xu, Xu, Xu, Xu, Xu, Xu, Xu, Xu, Xu, Xu, Xu, Xu, Xu, Xu, Xu, Xu
