Xu, Xu, Xu, Xu, Xu, Xu, Xu, Xu, Xu, Xu, Xu, Xu, Xu, Xu, Xu, Xu, Sm, Sm, Wog, Sm, Sm, Sm, Xu, Xu, Xu, Xu, Xu, Xu, Xu, Xu, Xu, Xu, Xu, Xu, Xu, Xu, Xu, Xu, Xu, Xu, Xu, Xu, Xu, Xu, Xu, Xu
Xu, Xu, Xu, Xu, Xu, Xu, Xu, Xu, Xu, Xu, Xu, Xu, Xu, Xu, Xu, Xu, Sm, Wog, Wog, Wog, Sm, Sm, Xu, Xu, Xu, Xu, Xu, Xu, Xu, Xu, Xu, Xu, Xu, Xu, Xu, Xu, Xu, Xu, Xu, Xu, Xu, Xu, Xu, Xu, Xu, Xu
Xu, Xu, Xu, Xu, Xu, Xu, Xu, Xu, Xu, Xu, Xu, Xu, Xu, Xu, Xu, Xu, Wog, Sm, Wog, Sm, Sm, Xu, Xu, Xu, Xu, Xu, Xu, Xu, Xu, Xu, Xu, Xu, Xu, Xu, Xu, Xu, Xu, Xu, Xu, Xu, Xu, Xu, Xu, Xu, Xu, Xu
Xu, Xu, Xu, Xu, Xu, Xu, Xu, Xu, Xu, Xu, Xu, Xu, Xu, Xu, Xu, Xu, Sm, Wog, Wog, Wog, Sm, Xu, Xu, Xu, Xu, Xu, Xu, Xu, Xu, Xu, Xu, Xu, Xu, Xu, Xu, Xu, Xu, Xu, Xu, Xu, Xu, Xu, Xu, Xu, Xu, Xu^_mh
Xu, Xu, Xu, Xu, Xu, Xu, Xu, Xu, Xu, Xu, Xu, Xu, Xu, Xu, Sm, Xu, Wog, Wog, Wog, Wog, Sm, Sm, Xu, Xu, Xu, Xu, Xu, Xu, Xu, Xu, Xu, Xu, Xu, Xu, Xu, Xu, Xu, Xu, Xu, Xu, Xu, Xu, Xu, Xu, Xu, Xu
Xu, Xu, Xu, Xu, Xu, Xu, Xu, Xu, Xu, Xu, Xu, Xu, Xu, Xu, Sm, Sm, Sm, Wog, Wog^Cov, Wog^Cov, Wog^Cov, Sm^Cov, Wog^Cov, Xu, Sm, Xu, Xu, Xu, Xu, Xu, Xu, Xu, Xu, Xu, Xu, Xu, Xu, Xu, Xu, Xu, Xu, Xu, Xu, Xu, Xu, Xu
Xu, Xu, Xu, Xu, Xu, Xu, Xu, Xu, Xu, Xu, Xu, Xu, Xu, Xu, Xu, Sm, Sm^Cov, Wog^Cov, Wog, Wog, Wog, Wog, Wog^Cov, Sm, Sm, Xu, Xu, Xu, Xu, Xu, Xu, Xu, Xu, Xu, Xu, Xu, Xu, Xu, Xu, Xu, Xu, Xu, Xu, Xu, Xu, Xu
Xu, Xu, Xu, Xu, Xu, Xu, Xu, Xu, Xu, Xu, Xu, Xu, Xu, Xu, Xu, Xu, Sm, Sm, Wog, Wog, Sm, Wog, 4 Wog^Kov, Xu, Xu, Sm, Xu, Xu, Xu, Xu, Xu, Xu, Xu, Xu, Xu, Xu, Xu, Xu, Xu, Xu, Xu, Xu, Xu, Xu, Xu, Xu
Xu, Xu, Xu, Xu, Xu, Xu, Xu, Xu, Xu, Xu, Xu, Xu, Xu, Xu, Sm, Sm, Xu, Sm, Sm, Wog, Wog, Wog, Wog, Xu, Xu, Xu, Xu, Xu, Xu, Xu, Xu, Xu, Xu, Xu, Xu, Xu, Xu, Xu, Xu, Xu, Xu, Xu, Xu, Xu, Xu, Xu
Xu, Xu, Xu, Xu, Xu, Xu, Xu, Xu, Xu, Xu, Sm^Qhu, Sm^Qhu, Sm^Qhu, Xu, Sm, Xu, Wog, Wog, Wog, Wog, Wog, Wog, Wog, Xu, Xu, Wwg, Xu, Xu, Xu, Xu, Xu, Xu, Xu, Xu, Xu, Xu, Xu, Xu, Xu, Xu, Xu, Xu, Xu, Xu, Xu, Xu
Xu, Xu, Xu, Xu, Xu, Xu, Xu, Xu, Xu, Sm^Qhu, Sm^Qhu, Sm^Qhu, Xu, Xu, Xu, Xu, Xu, Wog, Xu, Wog, Xu, Wog, Xu, Xu, Wwg, Wwg, Xu, Xu, Xu, Xu, Xu, Xu, Xu, Wog^Qhux, Xu, Xu, Xu, Xu, Xu, Xu, Xu, Xu, Xu, Xu, Xu, Xu
Xu, Xu, Xu, Xu, Xu, Xu, Xu, Xu, Xu, Sm^Qhu, Xu, Xu, Sm^Qhu, Xu, Xu, Xu, Xu, Xu, Xu, Xu, Wwg^Edb, Xur, Wwg^Edb, Xu, Wwg, Xu, Xu, Xu, Xu, Xu, Xu, Xu, Wog^Qhux, Wog^Qhux, Xu, Xu, Xu, Xu, Xu, Xu, Xu, Xu, Xu, Xu, Xu, Xu
Xu, Xu, Xu, Xu, Xu, Xu, Xu, Sm^Qhu, Sm^Qhu, Xu, Xu, Xu, Sm^Qhu, Xu, Xu, Xu, Sm^Edb, Xu, Wwg^Edb, Wwg^Edb, Uh^Qhh, Wwg^Edb, Urc^Qhh, Wwg, Wwg, Wwg, Xu, Xu, Xu, Xu, Xu, Xu, Wog^Qhux, Xu, Xu, Xu, Xu, Xu, Xu, Xu, Xu, Xu, Xu, Xu, Xu, Xu
Xu, Xu, Xu, Xu, Xu, Xu, Xu, Xu, Sm^Qhu, Xu, Xu, Sm^Qhu, Xu, Sm^Qhu, Sm^Qhu, Sm^Edb, Sm^Edb, Sm^Edb, Wwg^Edb, Uh^Qhh, Cte^Vov, Urc^Qhh, Kte^Ii, Urc^Qhh, Wwg, Wwg, Wwg, Wwg, Xu, Xu, Wog^Qhux, Wog^Qhux, Xu, Xu, Xu, Xu, Xu, Xu, Xu, Xu, Xu, Xu, Uh, Xu, Xu, Xu
Xu, Xu, Xu, Xu, Xu, Xu, Xu, Xu, Sm^Qhu, Xu, Xu, Sm^Qhu, Xu, Xu, Sm^Edb, Sm^Edb, Sm^Edb, Sm^Edb, Sm^Edb, Uh^Qhh, Wwg^Edb, Urc^Qhh, Urc^Qhh, Urc^Qhh, Ur^Qhh, Uh^Qhh, Uh^Qhh, Wwg, Wwg, Wog^Qhux, Urc^Qhh, Wog^Qhux, Wog^Qhux, Xu, Xu, Xu, Xu, Xu, Xu, Xu, Xu, Xu, Uh, Uh, Uu^Es, Uu
Xu, Xu, Xu, Xu, Xu, Xu, Xu, Sm^Qhu, Sm^Qhu, Sm^Qhu, Sm^Qhu, Xu, Uu^Qhh, Uu^Qhh, Uu^Qhh, Sm^Edb, Xu, Uu, Uu, Sm^Edb, Wwg^Edb, Wwg^Edb, Ur^Es, Ur^Qhh, Urc^Qhh, Ur^Qhh, Uh^Qhh, Wwg, Wwg, Urc^Qhh, Kte^Ii, Urc^Qhh, Wog^Qhux, Xu, Xu, Xu, Xu, Xu, 1 Kte, Xu, Xu, Xu, Uu, Uu^Es, Ur, Ur^Es
Xu, Xu, Xu, Xu, Xu, Xu, Xu, Sm^Qhu, Sm^Qhu, Xu, Xu, Xu, Sm, Uu^Qhh, Xu, Xu, Uu^Qhh, Uu, Ss^Qhu, Wwg^Edb, Wwg^Edb, Uh^Qhh, Cte^Vov, Urc^Qhh, Kte^Ii, Urc^Qhh, Ur^Es, Ur^Es, Wwg^Bs/, Urc^Qhh, Urc^Qhh, Urc^Qhh, Wwg, Xu, Tb^Tf, Xu, Cte^Eb, Cte^Es, Cte, Cte^Es, Cte^Eb, Rb^Es, Ur^Es, Ur^Es, Uu, Uu
Xu, Xu, Xu, Xu, Xu, Xu, Xu, Xu, Xu, Sm^Qhu, Uu, Cer, Sm, Ss, Xu, Xu, Uu^Qhh, Ss^Qhu, Ss^Qhu, Ss^Qhu, Wwg^Edb, Wwg^Edb, Uh^Qhh, Urc^Qhh, Urc^Qhh, Urc^Qhh, Ur^Es, Ur^Es, Cte^Vov, Wwg, Ur^Qhh, Ur^Qhh, Wwg, Uh, Uh, Rb^Es, Rb^Qhh, Cte^Vov, Rb, Cte^Vov, Rb, Rb, Uu, Uu, Uh, Uh
Xu, Xu, Xu, Xu, Xu, Xu, Xu, Xu, Xu, Ss^Qhu, Uu, Xu, Xu, Xu, Ss^Qhu, Uh^Qhh, Uu^Qhh, Uu, Ss^Qhu, Ss^Qhu, Wwg^Edb, Wwg^Edb, Wwg^Edb, Ur^Es, Ur^Es, Ur^Es, Ur^Qhh, Ur^Es, Urc^Qhh, Wwg, Wwg, Wwg, Xu, Uh, Uu, Uu^Es, Uu^Es, Rb^Qhh, Rb, Rb^Es, Ur^Es, Ur, Uu, Tb^Tf, Uh^Tf, Xu
Xu, Xu, Xu, Xu, Xu, Xu, Xu, Xu, Rb, Ss^Qhu, Uu^Vu, Xu, Ss^Qhu, Xu, Xu, Sm^Qhu, Sm^Qhu, Uu, Uu, Wwg^Edb, Uh^Qhh, Urc^Qhh, Urc^Qhh, Wwg^Bs/, Cte^Vov, Ur^Es, Urc^Qhh, Urc^Qhh, Kte, Urc^Qhh, Urc^Qhh, Wwg, Uu^Es, Uu, Ur^Es, Ur^Es, Rb, Rb^Qhh, Rb, Rb^Es, Rb^Es, Uu^Es, Xu, Xu, Xu, Xu
Xu, Xu, Xu, Xu, Xu, Xu, Xu, Cer, Rb, Uu, Xu, Xu, Ss^Qhu, Tb^Tf, Uu, Cer, Xu, Xu, Uu^Qhh, Wwg^Edb, Wwg^Edb, Kte^Ii, Urc^Qhh, Wwg^Edb, Wwg^Edb, Ur^Qhh, Urc^Qhh, Kte, Kte^Ii, Kte, Urc^Qhh, Wwg, Wwg^Bs/, Ur^Es, Uu^Es, Rb^Es, Cte^Eb, Cte^Vov, 2 Kte, Cte^Vov, Cte^Eb, Uh, Uh, Xu, Xu, Xu
Xu, Xu, Xu, Xu, Xu, Xu, Xu, Cer, Rb, Uu, Xu, Ss^Qhu, Tb, Uu, Uu, Ss, Xu, Uu^Qhh, Uu^Qhh, Uu, Wwg^Edb, Uh^Qhh, Wwg^Edb, Wwg^Edb, Uh^Qhh, Ur^Qhh, Urc^Qhh, Kte, Kte, Kte, Urc^Qhh, Ur^Es, Cte^Vov, Wwg, Xu, Uh, Xu, Cte^Es, Xu, Cte^Es, Xu, Xu, Xu, Xu, Xu, Xu
Xu, Xu, Xu, Tb^Tf, Xu, Xu, Xu, Cer, Cer, Rb, Uu, Tb, Uu^Vu, Uu, Xu, Xu, Xu, Xu, Ss^Qhu, Ss^Qhu, Ss^Qhu, Wwg^Edb, Wwg^Edb, Wwg^Edb, Wwg^Edb, Cte^Vov, Ur^Qhh, Urc^Qhh, Urc^Qhh, Urc^Qhh, Ur^Es, Ur^Es, Uh^Qhh, Wwg, Wwg, Wwg, Xu, Xu, Xu, Xu, Xu, Xu, Xu, Xu, Xu, Xu
Xu, Xu, Tb^Tf, Tb^Tf, Tb, Xu, Uu, Rb, Cer, Rb, Rb, Tb, Xu, Ss, Xu, Xu, Xu, Sm^Qhu, Sm^Qhu, Ss^Qhu, Ss^Qhu, Uu, Uu, Uu, Wwg^Edb, Uh^Qhh, Cte^Vov, Ur^Qhh, Ur^Qhh, Ur^Qhh, Ur^Es, Ur^Es, Urc^Qhh, Urc^Qhh, Urc^Qhh, Wwg, Wwg, Xu, Xu, Xu, Xu, Xu, Xu, Xu, Xu, Xu
Xu, Xu, Tb^Tf, Tb^Tf, Rb^Vu, Rb, Rb^Vu, Rb, Rb, Cer, Rb, Xu, Xu, Xu, Xu, Ss, Tb, Cer, Xu, Ss, Xu, Xu, Ss^Qhu, Ss^Qhu, Wwg^Edb, Wwg^Edb, Wwg^Edb, Uh^Qhh, Uh^Qhh, Ur^Es, Ur^Es, Ur^Es, Urc^Qhh, Kte^Ii, Urc^Qhh, Uh^Qhh, Wwg, Xu, Wwg, Xu, Xu, Xu, Xu, Xu, Xu, Xu
Tb, Uh, Uu, Tb, Rb, Uu, Rb, Uu, Rb, Cer, Cer, Rb, Uu, Uh, Uu, Uu^Vu, Uu, Uu, Ss, Xu, Xu, Xu, Uu, Ss^Qhu, Ss^Qhu, Uu, Wwg^Edb, Wwg^Edb, Uh^Qhh, Ur^Qhh, Urc^Qhh, Ur^Qhh, Cte^Vov, Urc^Qhh, Uh^Qhh, Wwg, Wwg, Wwg, Xu, Wwg, Xu, Xu, Xu, Xu, Xu, Xu
Tb^Tf, Tb, Rb^Vu, Uu, Rb^Vu, Uu, Rb^Vu, Uu, Rb, Ko, Cer, Rb, Rb, Uu, Xu, Ss^Qhu, Xu, Tb, Xu, Xu, Sm^Qhu, Tb^Qhh, Uu^Qhh, Uu, Xu, Uu, Uu, Wwg^Edb, Wwg^Edb, Urc^Qhh, Kte^Ii, Urc^Qhh, Wwg^Edb, Uh^Qhh, Wwg, Uh^Qhh, Wwg, Xu, Xu, Xu, Xu, Xu, Xu, Xu, Xu, Xu
Tb, Tb, Uu, Rb, Uu, Uu, Rb, Uu, Rb, 3 Ko, Ko, Cer, Rb, Ss^Qhu, Uu, Xu, Uu, Xu, Ss^Qhu, Xu, Cer, Sm^Qhu, Ss^Qhu, Tb^Qhh, Xu, Xu, Uu^Qhh, Uu, Wwg^Edb, Urc^Qhh, Urc^Qhh, Urc^Qhh, Wwg^Edb, Wwg^Edb, Wwg, Wwg, Wwg, Xu, Xu, Xu, Xu, Xu, Xu, Xu, Xu, Xu
Uu, Tb, Uu, Uu, Rb, Rb^Vu, Uu, Rb^Vu, Uu, Rb, Rb, Cer, Cer, Rb, Uu, Uu, Ss^Qhu, Uu^Vu, Uu, Uu, Tb, Xu, Xu, Xu, Xu, Uu^Qhh, Sm^Edb, Sm^Edb, Sm^Edb, Sm^Edb, Wwg^Edb, Wwg^Edb, Wwg^Edb, Wwg^Edb, Xu, Xu, Xu, Wwg, Xu, Xu, Xu, Xu, Xu, Xu, Xu, Xu
Uu, Uu, Uu, Rb^Vu, Uu, Uu, Tb, Tb, Uu, Uu, Uu, Rb, Cer, Rb, Rb, Ss^Qhu, Xu, Xu, Xu, Ss^Qhu, Xu, Xu, Xu, Tb, Uu^Qhh, Uu, Uu, Xu, Xu, Sm^Edb, Xu, Xu, Xu, Xu, Wog, Wog, Wog, Xu, Xu, Xu, Sm, Xu, Sm, Xu, Xu, Xu
Uu, Uu, Uh, Rb, Rb, Rb^Vu, Uh, Tb, Uh, Rb^Vu, Rb, Rb, Rb, Cer, Rb, Uu, Tb, Tb^Tf, Xu, Xu, Uu, Xu, Cer, Sm^Qhu, Uu^Qhh, Uu^Qhh, Xu, Xu, Sm^Edb, Sm^Edb, Xu, Xu, Wog, Wog, Wog, Wog, Wog, Xu, Wog^Cov, Xu, Sm, Sm, Sm, Xu, Xu, Xu
Uu, Uh, Tb, Xu, Uh, Uu, Tb, Tb^Tf, Tb^Tf, Uu, Uu, Rb, Rb, Cer, Cer, Rb, Rb, Tb, Uu, Uu^Vu, Uu, Uu, Xu, Sm^Qhu, Xu, Uu^Qhh, Sm^Qhu, Xu, Xu, Xu, Xu, Xu, Xu, Wog, Wog, Wog, Wog, Wog, Wog^Cov, Wog^Cov, Wog, Sm, Wog, Sm, Sm, Sm
Xu, Tb, Tb^Tf, Xu, Xu, Xu, Tb, Tb^Tf, Tb^Tf, Tb^Tf, Tb, Xu, Xu, Xu, Xu, Cer, Tb, Uu, Xu, Tb, Xu, Tb, Xu, Sm^Qhu, Sm^Qhu, Xu, Sm^Qhu, Xu, Xu, Xu, Sm, Xu, Xu, Xu, Wog, Wog, Wog^Cov, Wog^Cov, Wog^Cov, Wog^Cov, Wog, Wog, Wog, Sm, Sm, Sm
Xu, Xu, Xu, Xu, Xu, Xu, Xu, Xu, Xu, Xu, Xu, Xu, Xu, Xu, Xu, Xu, Xu, Xu, Xu, Xu, Xu, Xu, Xu, Xu, Sm^Qhu, Sm^Qhu, Xu, Sm^Qhu, Xu, Sm, Xu, Sm, Xu, Xu, Wog^Kov, Wog^Cov, Sm^Cov, Sm^Cov, Sm, Wog, Wog, Wog, Wog, Wog, Sm, Sm
Xu, Xu, Xu, Xu, Xu, Xu, Xu, Xu, Xu, Xu, Xu, Xu, Xu, Xu, Xu, Xu, Xu, Xu, Xu, Xu, Xu, Xu, Xu, Xu, Sm^Qhu, Sm^Qhu, Xu, Sm^Qhu, Xu, Xu, Xu, Sm, Sm, Sm, Xu, Sm^Cov, Sm, Sm, Sm, Wog, Wog, Sm, Sm, Wog, Wog, Wog
Xu, Xu, Xu, Xu, Xu, Xu, Xu, Xu, Xu, Xu, Xu, Xu, Xu, Xu, Xu, Xu, Xu, Xu, Xu, Xu, Xu, Xu, Xu, Xu, Xu, Xu, Xu, Sm^Qhu, Xu, Sm^Qhu, Sm^Qhu, Xu, Xu, Xu, Sm, Xu, Sm, Xu, Xu, Xu, Sm, Sm, Sm, Wog, Wog, Wog
Xu, Xu, Xu, Xu, Xu, Xu, Xu, Xu, Xu, Xu, Xu, Xu, Xu, Xu, Xu, Xu, Xu, Xu, Xu, Xu, Xu, Xu, Xu, Xu, Xu, Xu, Xu, Xu, Xu, Sm^Qhu, Xu, Sm^Qhu, Xu, Xu, Xu, Sm, Xu, Xu, Xu, Xu, Xu, Xu, Sm, Wog, Sm, Wog
Xu, Xu, Xu, Xu, Xu, Xu, Xu, Xu, Xu, Xu, Xu, Xu, Xu, Xu, Xu, Xu, Xu, Xu, Xu, Xu, Xu, Xu, Xu, Xu, Xu, Xu, Xu, Xu, Xu, Xu, Xu, Xu, Xu, Xu, Xu, Xu, Xu, Xu, Xu, Xu, Xu, Xu, Xu, Sm, Sm, Wog
Xu, Xu, Xu, Xu, Xu, Xu, Xu, Xu, Xu, Xu, Xu, Xu, Xu, Xu, Xu, Xu, Xu, Xu, Xu, Xu, Xu, Xu, Xu, Xu, Xu, Xu, Xu, Xu, Xu, Xu, Xu, Xu, Xu, Xu, Xu, Xu, Xu, Xu, Xu, Xu, Xu, Xu, Xu, Sm, Sm, Sm
Xu, Xu, Xu, Xu, Xu, Xu, Xu, Xu, Xu, Xu, Xu, Xu, Xu, Xu, Xu, Xu, Xu, Xu, Xu, Xu, Xu, Xu, Xu, Xu, Xu, Xu, Xu, Xu, Xu, Xu, Xu, Xu, Xu, Xu, Xu, Xu, Xu, Xu, Xu, Xu, Xu, Xu, Sm, Sm, Sm, Sm
