Xu, Xu, Xu, Xu, Xu, Xu, Xu, Xu, Xu, Xu, Xu, Xu, Xu, Xu, Xu, Xu, Sm, Sm, Wog, Sm, Sm, Sm, Xu, Xu, Xu, Xu, Xu, Xu, Xu, Xu, Xu, Xu, Xu, Xu, Xu, Xu, Xu, Xu, Xu, Xu, Xu, Xu, Xu, Xu, Xu, Xu
Xu, Xu, Xu, Xu, Xu, Xu, Xu, Xu, Xu, Xu, Xu, Xu, Xu, Xu, Xu, Xu, Sm, Wog, Wog, Wog, Sm, Sm, Xu, Xu, Xu, Xu, Xu, Xu, Xu, Xu, Xu, Xu, Xu, Xu, Xu, Xu, Xu, Xu, Xu, Xu, Xu, Xu, Xu, Xu, Xu, Xu
Xu, Xu, Xu, Xu, Xu, Xu, Xu, Xu, Xu, Xu, Xu, Xu, Xu, Xu, Xu, Xu, Wog, Sm, Wog, Sm, Sm, Xu, Xu, Xu, Xu, Xu, Xu, Xu, Xu, Xu, Xu, Xu, Xu, Xu, Xu, Xu, Xu, Xu, Xu, Xu, Xu, Xu, Xu, Xu, Xu, Xu
Xu, Xu, Xu, Xu, Xu, Xu, Xu, Xu, Xu, Xu, Xu, Xu, Xu, Xu, Xu, Xu, Sm, Wog, Wog, Wog, Sm, Xu, Xu, Xu, Xu, Xu, Xu, Xu, Xu, Xu, Xu, Xu, Xu, Xu, Xu, Xu, Xu, Xu, Xu, Xu, Xu, Xu, Xu, Xu, Xu, Xu
Xu, Xu, Xu, Xu, Xu, Xu, Xu, Xu, Xu, Xu, Xu, Xu, Xu, Xu, Sm, Xu, Wog, Wog, Wog, Wog, Sm, Sm, Xu, Xu, Xu, Xu, Xu, Xu, Xu, Xu, Xu, Xu, Xu, Xu, Xu, Xu, Xu, Xu, Xu, Xu, Xu, Xu, Xu, Xu, Xu, Xu
Xu, Xu, Xu, Xu, Xu, Xu, Xu, Xu, Xu, Xu, Xu, Xu, Xu, Xu, Sm, Sm, Sm, Wog, Wog^Cov, Wog^Cov, Wog^Cov, Sm^Cov, Wog^Cov, Xu, Sm, Xu, Xu, Xu, Xu, Xu, Xu, Xu, Xu, Xu, Xu, Xu, Xu, Xu, Xu, Xu, Xu, Xu, Xu, Xu, Xu, Xu
Xu, Xu, Xu, Xu, Xu, Xu, Xu, Xu, Xu, Xu, Xu, Xu, Xu, Xu, Xu, Sm, Sm^Cov, Wog^Cov, Wog, Wog, Wog, Wog, Wog^Cov, Sm, Sm, Xu, Xu, Xu, Xu, Xu, Xu, Xu, Xu, Xu, Xu, Xu, Xu, Xu, Xu, Xu, Xu, Xu, Xu, Xu, Xu, Xu
Xu, Xu, Xu, Xu, Xu, Xu, Xu, Xu, Xu, Xu, Xu, Xu, Xu, Xu, Xu, Xu, Sm, Sm, Wog, Wog, Sm, Wog, 4 Wog^Kov, Xu, Xu, Sm, Xu, Xu, Xu, Xu, Xu, Xu, Xu, Xu, Xu, Xu, Xu, Xu, Xu, Xu, Xu, Xu, Xu, Xu, Xu, Xu
Xu, Xu, Xu, Xu, Xu, Xu, Xu, Xu, Xu, Xu, Xu, Xu, Xu, Xu, Sm, Sm, Xu, Sm, Sm, Wog, Wog, Wog, Wog, Xu, Xu, Xu, Xu, Xu, Xu, Xu, Xu, Xu, Xu, Xu, Xu, Xu, Xu, Xu, Xu, Xu, Xu, Xu, Xu, Xu, Xu, Xu
Xu, Xu, Xu, Xu, Xu, Xu, Xu, Xu, Xu, Xu, Sm, Sm, Sm, Xu, Sm, Xu, Wog, Wog, Wog, Wog, Wog, Wog, Wog, Xu, Xu, Wwg, Xu, Xu, Xu, Xu, Xu, Xu, Xu, Xu, Xu, Xu, Xu, Xu, Xu, Xu, Xu, Xu, Xu, Xu, Xu, Xu
Xu, Xu, Xu, Xu, Xu, Xu, Xu, Xu, Xu, Sm, Sm, Sm, Xu, Xu, Xu, Xu, Xu, Wog, Xu, Wog, Xu, Wog, Xu, Xu, Wwg, Wwg, Xu, Xu, Xu, Xu, Xu, Xu, Xu, Xu, Xu, Xu, Xu, Xu, Xu, Xu, Xu, Xu, Xu, Xu, Xu, Xu
Xu, Xu, Xu, Xu, Xu, Xu, Xu, Xu, Xu, Sm, Xu, Xu, Sm, Xu, Xu, Xu, Xu, Xu, Xu, Xu, Wwg^Edb, Xu, Wwg^Edb, Xu, Wwg, Xu, Xu, Xu, Xu, Xu, Xu, Xu, Xu, Xu, Xu, Xu, Xu, Xu, Xu, Xu, Xu, Xu, Xu, Xu, Xu, Xu
Xu, Xu, Xu, Xu, Xu, Xu, Xu, Sm, Sm, Xu, Xu, Xu, Sm, Xu, Xu, Xu, Sm^Edb, Xu, Wwg^Edb, Wwg^Edb, Uh, Wwg^Edb, Urc, Wwg, Wwg, Wwg, Xu, Xu, Xu, Xu, Xu, Xu, Wwg, Xu, Xu, Xu, Xu, Xu, Xu, Xu, Xu, Xu, Xu, Xu, Xu, Xu
Xu, Xu, Xu, Xu, Xu, Xu, Xu, Xu, Sm, Xu, Xu, Sm, Xu, Sm, Sm, Sm^Edb, Sm^Edb, Sm^Edb, Wwg^Edb, Uh, Cte^Vov, Urc, Kte^Ii, Urc^Ebn, Wwg, Wwg, Wwg, Wwg, Xu, Xu, Wwg, Wwg, Xu, Xu, Xu, Xu, Xu, Xu, Xu, Xu, Xu, Xu, Uh, Xu, Xu, Xu
Xu, Xu, Xu, Xu, Xu, Xu, Xu, Xu, Sm, Xu, Xu, Sm, Xu, Xu, Sm^Edb, Sm^Edb, Sm^Edb, Sm^Edb, Sm^Edb, Uh, Wwg^Edb, Urc, Urc^Ebn, Urc, Ur^Es, Uh, Uh, Wwg, Wwg, Wwg, Urc, Wwg, Wwg, Xu, Xu, Xu, Xu, Xu, Xu, Xu, Xu, Xu, Uh, Uh, Uu^Es, Uu
Xu, Xu, Xu, Xu, Xu, Xu, Xu, Sm, Sm, Sm, Sm, Xu, Uu, Uu, Uu, Sm^Edb, Xu, Uu, Uu, Sm^Edb, Wwg^Edb, Wwg^Edb, Ur^Es, Ur^Es, Urc, Ur^Es, Uh, Wwg, Wwg, Urc^Ebn, Kte^Ii, Urc, Wwg, Xu, Xu, Xu, Xu, Xu, 1 Kte, Xu, Xu, Xu, Uu, Uu^Es, Ur, Ur^Es
Xu, Xu, Xu, Xu, Xu, Xu, Xu, Sm, Sm, Xu, Xu, Xu, Sm, Uu, Xu, Xu, Uu, Uu, Ss^Edb, Wwg^Edb, Wwg^Edb, Uh, Cte^Vov, Urc, Kte^Ii, Urc^Ebn, Ur^Es, Ur^Es, Wwg^Bs/, Urc, Urc^Ebn, Urc, Wwg, Xu, Tb^Tf, Xu, Cte^Eb, Cte^Es, Cte, Cte^Es, Cte^Eb, Rb^Es, Ur^Es, Ur^Es, Uu, Uu
Xu, Xu, Xu, Xu, Xu, Xu, Xu, Xu, Xu, Sm, Uu, Cer, Sm, Ss, Xu, Xu, Uu, Ss^Edb, Ss^Edb, Ss^Edb, Wwg^Edb, Wwg^Edb, Uh, Urc^Ebn, Urc, Urc, Ur^Es, Ur^Es, Cte^Vov, Wwg, Ur^Es, Ur^Es, Wwg, Uh, Uh, Rb^Es, Rb^Es, Cte^Vov, Rb, Cte^Vov, Rb, Rb, Uu, Uu, Uh, Uh
Xu, Xu, Xu, Xu, Xu, Xu, Xu, Xu, Xu, Ss, Uu, Xu, Xu, Xu, Ss, Uh, Uu, Uu, Ss^Edb, Ss^Edb, Wwg^Edb, Wwg^Edb, Wwg^Edb, Ur^Es, Ur^Es, Ur^Es, Ur^Es, Ur^Es, Urc, Wwg, Wwg, Wwg, Xu, Uh, Uu, Uu^Es, Uu^Es, Rb, Rb, Rb^Es, Ur^Es, Ur, Uu, Tb^Tf, Uh^Tf, Xu
Xu, Xu, Xu, Xu, Xu, Xu, Xu, Xu, Rb, Ss, Uu^Vu, Xu, Ss, Xu, Xu, Sm, Sm, Uu, Uu, Wwg^Edb, Uh, Urc^Ebn, Urc, Wwg^Bs/, Cte^Vov, Ur^Es, Urc, Urc, Kte, Urc, Urc, Wwg, Uu^Es, Uu, Ur^Es, Ur^Es, Rb, Rb, Rb, Rb^Es, Rb^Es, Uu^Es, Xu, Xu, Xu, Xu
Xu, Xu, Xu, Xu, Xu, Xu, Xu, Cer, Rb, Uu, Xu, Xu, Ss, Tb^Tf, Uu, Cer, Xu, Xu, Uu, Wwg^Edb, Wwg^Edb, Kte^Ii, Urc^Ebn, Wwg^Edb, Wwg^Edb, Ur^Es, Urc, Kte, Kte^Ii, Kte, Urc, Wwg, Wwg^Bs/, Ur^Es, Uu^Es, Rb^Es, Cte^Eb, Cte^Vov, 2 Kte, Cte^Vov, Cte^Eb, Uh, Uh, Xu, Xu, Xu
Xu, Xu, Xu, Xu, Xu, Xu, Xu, Cer, Rb, Uu, Xu, Ss, Tb, Uu, Uu, Ss, Xu, Uu, Uu, Uu, Wwg^Edb, Uh, Wwg^Edb, Wwg^Edb, Uh, Ur^Es, Urc, Kte, Kte, Kte, Urc, Ur^Es, Cte^Vov, Wwg, Xu, Uh, Xu, Cte^Es, Xu, Cte^Es, Xu, Xu, Xu, Xu, Xu, Xu
Xu, Xu, Xu, Tb^Tf, Xu, Xu, Xu, Cer, Cer, Rb, Uu, Tb, Uu^Vu, Uu, Xu, Xu, Xu, Xu, Ss^Edb, Ss^Edb, Ss^Edb, Wwg^Edb, Wwg^Edb, Wwg^Edb, Wwg^Edb, Cte^Vov, Ur^Es, Urc, Urc, Urc, Ur^Es, Ur^Es, Uh, Wwg, Wwg, Wwg, Xu, Xu, Xu, Xu, Xu, Xu, Xu, Xu, Xu, Xu
Xu, Xu, Tb^Tf, Tb^Tf, Tb, Xu, Uu, Rb, Cer, Rb, Rb, Tb, Xu, Ss, Xu, Xu, Xu, Sm, Sm, Ss^Edb, Ss^Edb, Uu, Uu, Uu, Wwg^Edb, Uh, Cte^Vov, Ur^Es, Ur^Es, Ur^Es, Ur^Es, Ur^Es, Urc, Urc^Ebn, Urc, Wwg, Wwg, Xu, Xu, Xu, Xu, Xu, Xu, Xu, Xu, Xu
Xu, Xu, Tb^Tf, Tb^Tf, Rb^Vu, Rb, Rb^Vu, Rb, Rb, Cer, Rb, Xu, Xu, Xu, Xu, Ss, Tb, Cer, Xu, Ss, Xu, Xu, Ss^Edb, Ss^Edb, Wwg^Edb, Wwg^Edb, Wwg^Edb, Uh, Uh, Ur^Es, Ur^Es, Ur^Es, Urc^Ebn, Kte^Ii, Urc, Uh, Wwg, Xu, Wwg, Xu, Xu, Xu, Xu, Xu, Xu, Xu
Tb, Uh, Uu, Tb, Rb, Uu, Rb, Uu, Rb, Cer, Cer, Rb, Uu, Uh, Uu, Uu^Vu, Uu, Uu, Ss, Xu, Xu, Xu, Uu, Ss^Edb, Ss^Edb, Uu, Wwg^Edb, Wwg^Edb, Uh, Ur^Es, Urc, Ur^Es, Cte^Vov, Urc, Uh, Wwg, Wwg, Wwg, Xu, Wwg, Xu, Xu, Xu, Xu, Xu, Xu
Tb^Tf, Tb, Rb^Vu, Uu, Rb^Vu, Uu, Rb^Vu, Uu, Rb, Ko, Cer, Rb, Rb, Uu, Xu, Ss, Xu, Tb, Xu, Xu, Sm, Tb, Uu, Uu, Xu, Uu, Uu, Wwg^Edb, Wwg^Edb, Urc^Ebn, Kte^Ii, Urc^Ebn, Wwg^Edb, Uh, Wwg, Uh, Wwg, Xu, Xu, Xu, Xu, Xu, Xu, Xu, Xu, Xu
Tb, Tb, Uu, Rb, Uu, Uu, Rb, Uu, Rb, 3 Ko, Ko, Cer, Rb, Ss, Uu, Xu, Uu, Xu, Ss, Xu, Cer, Sm, Ss, Tb, Xu, Xu, Uu, Uu, Wwg^Edb, Urc, Urc, Urc, Wwg^Edb, Wwg^Edb, Wwg, Wwg, Wwg, Xu, Xu, Xu, Xu, Xu, Xu, Xu, Xu, Xu
Uu, Tb, Uu, Uu, Rb, Rb^Vu, Uu, Rb^Vu, Uu, Rb, Rb, Cer, Cer, Rb, Uu, Uu, Ss, Uu^Vu, Uu, Uu, Tb, Xu, Xu, Xu, Xu, Uu, Sm^Edb, Sm^Edb, Sm^Edb, Sm^Edb, Wwg^Edb, Wwg^Edb, Wwg^Edb, Wwg^Edb, Xu, Xu, Xu, Wwg, Xu, Xu, Xu, Xu, Xu, Xu, Xu, Xu
Uu, Uu, Uu, Rb^Vu, Uu, Uu, Tb, Tb, Uu, Uu, Uu, Rb, Cer, Rb, Rb, Ss, Xu, Xu, Xu, Ss, Xu, Xu, Xu, Tb, Uu, Uu, Uu, Xu, Xu, Sm^Edb, Xu, Xu, Xu, Xu, Wog, Wog, Wog, Xu, Xu, Xu, Sm, Xu, Sm, Xu, Xu, Xu
Uu, Uu, Uh, Rb, Rb, Rb^Vu, Uh, Tb, Uh, Rb^Vu, Rb, Rb, Rb, Cer, Rb, Uu, Tb, Tb^Tf, Xu, Xu, Uu, Xu, Cer, Sm, Uu, Uu, Xu, Xu, Sm^Edb, Sm^Edb, Xu, Xu, Wog, Wog, Wog, Wog, Wog, Xu, Wog^Cov, Xu, Sm, Sm, Sm, Xu, Xu, Xu
Uu, Uh, Tb, Xu, Uh, Uu, Tb, Tb^Tf, Tb^Tf, Uu, Uu, Rb, Rb, Cer, Cer, Rb, Rb, Tb, Uu, Uu^Vu, Uu, Uu, Xu, Sm, Xu, Uu, Sm, Xu, Xu, Xu, Xu, Xu, Xu, Wog, Wog, Wog, Wog, Wog, Wog^Cov, Wog^Cov, Wog, Sm, Wog, Sm, Sm, Sm
Xu, Tb, Tb^Tf, Xu, Xu, Xu, Tb, Tb^Tf, Tb^Tf, Tb^Tf, Tb, Xu, Xu, Xu, Xu, Cer, Tb, Uu, Xu, Tb, Xu, Tb, Xu, Sm, Sm, Xu, Sm, Xu, Xu, Xu, Sm, Xu, Xu, Xu, Wog, Wog, Wog^Cov, Wog^Cov, Wog^Cov, Wog^Cov, Wog, Wog, Wog, Sm, Sm, Sm
Xu, Xu, Xu, Xu, Xu, Xu, Xu, Xu, Xu, Xu, Xu, Xu, Xu, Xu, Xu, Xu, Xu, Xu, Xu, Xu, Xu, Xu, Xu, Xu, Sm, Sm, Xu, Sm, Xu, Sm, Xu, Sm, Xu, Xu, Wog^Kov, Wog^Cov, Sm^Cov, Sm^Cov, Sm, Wog, Wog, Wog, Wog, Wog, Sm, Sm
Xu, Xu, Xu, Xu, Xu, Xu, Xu, Xu, Xu, Xu, Xu, Xu, Xu, Xu, Xu, Xu, Xu, Xu, Xu, Xu, Xu, Xu, Xu, Xu, Sm, Sm, Xu, Sm, Xu, Xu, Xu, Sm, Sm, Sm, Xu, Sm^Cov, Sm, Sm, Sm, Wog, Wog, Sm, Sm, Wog, Wog, Wog
Xu, Xu, Xu, Xu, Xu, Xu, Xu, Xu, Xu, Xu, Xu, Xu, Xu, Xu, Xu, Xu, Xu, Xu, Xu, Xu, Xu, Xu, Xu, Xu, Xu, Xu, Xu, Sm, Xu, Sm, Sm, Xu, Xu, Xu, Sm, Xu, Sm, Xu, Xu, Xu, Sm, Sm, Sm, Wog, Wog, Wog
Xu, Xu, Xu, Xu, Xu, Xu, Xu, Xu, Xu, Xu, Xu, Xu, Xu, Xu, Xu, Xu, Xu, Xu, Xu, Xu, Xu, Xu, Xu, Xu, Xu, Xu, Xu, Xu, Xu, Sm, Xu, Sm, Xu, Xu, Xu, Sm, Xu, Xu, Xu, Xu, Xu, Xu, Sm, Wog, Sm, Wog
Xu, Xu, Xu, Xu, Xu, Xu, Xu, Xu, Xu, Xu, Xu, Xu, Xu, Xu, Xu, Xu, Xu, Xu, Xu, Xu, Xu, Xu, Xu, Xu, Xu, Xu, Xu, Xu, Xu, Xu, Xu, Xu, Xu, Xu, Xu, Xu, Xu, Xu, Xu, Xu, Xu, Xu, Xu, Sm, Sm, Wog
Xu, Xu, Xu, Xu, Xu, Xu, Xu, Xu, Xu, Xu, Xu, Xu, Xu, Xu, Xu, Xu, Xu, Xu, Xu, Xu, Xu, Xu, Xu, Xu, Xu, Xu, Xu, Xu, Xu, Xu, Xu, Xu, Xu, Xu, Xu, Xu, Xu, Xu, Xu, Xu, Xu, Xu, Xu, Sm, Sm, Sm
Xu, Xu, Xu, Xu, Xu, Xu, Xu, Xu, Xu, Xu, Xu, Xu, Xu, Xu, Xu, Xu, Xu, Xu, Xu, Xu, Xu, Xu, Xu, Xu, Xu, Xu, Xu, Xu, Xu, Xu, Xu, Xu, Xu, Xu, Xu, Xu, Xu, Xu, Xu, Xu, Xu, Xu, Sm, Sm, Sm, Sm
