Hhd^Qhh, Mm^Qhh, Mm^Qhh, Mm^Qhh, Mm^Qhh, Mm^Qhh, Hhd^Qhh, Gd, Hhd^Qhh, Hhd^Qhh, Re, Re, Re, Hhd^Qhh, Hhd^Qhh, Hhd^Edt, Hhd^Qhh, Hhd^Qhux, Hhd^Qhux, Hhd^Qhux, Hhd^Qhh, Hhd^Qhh, Hhd^Qhh, Hhd^Qhh, Hhd^Qhh, Re, Re, Re, Re^Es, Rb^Edt, Hhd^Qhh, Hhd^Qhh, Hhd^Qhh, Gll^Fp, Gll^Fp, Gll^Fp, Gll^Fmw, Gll^Fp, Gll^Fp, Mm^Qhh, Mm^Qhh, Hhd^Qhh, Hhd^Qhux, Hhd^Qhh, Hhd^Qhux, Mm^Qhux, Hhd^Qhux, Hhd^Qhux, Mm^Qhh, Hhd^Qhh, Hhd^Qhh
Hhd^Qhh, Hhd^Qhh, Hhd^Qhh, Mm^Qhh, Mm^Qhh, Mm^Qhh, Hhd^Qhh, Hhd^Qhh, Re, Re, Rb, Rb, Hhd^Qhh, Hhd^Qhh, Hhd^Qhh, Hhd^Qhh, Hhd^Qhh, Hhd^Qhux, Ko, Hhd^Qhux, Hhd^Qhh, Hhd^Qhh, Hhd^Qhh, Re^Es, Re, Re, Re, Re, Hhd^Qhh, Hhd^Qhh, Hhd^Qhh, Hhd^Qhh, Sm^Qhu, Co, Gll^Fp, Gll^Fp, Gll^Vo, Gll^Fmw, Gll^Fmw, Gll^Fp, Hhd^Qhh, Hhd^Qhh, Re^Es, Hhd^Qhux, Hhd^Qhux, Hhd^Qhux, Hhd^Qhux, Hhd^Qhh, Mm^Qhh, Mm^Qhh, Hhd^Qhh
Mm^Qhh, Hhd^Qhh, Hhd^Qhh, Hhd^Qhh, Hhd^Qhux, Hhd^Qhh, Hhd^Qhh, Hhd^Qhh, Re^Es, Re, Rb, Co^Emf, Co^Vo, Sm, Sm, Sm, Hhd^Qhh, Hhd^Qhh, Hhd^Qhh, Hhd^Qhh, Hhd^Qhh, Re^Es, Re, Re, Sm^Qhu, Sm^Qhu, Sm^Qhu, Re, Sm^Qhu, Sm^Qhu, Sm^Qhu, Hhd^Qhh, Hhd^Qhh, Sm^Qhu, Re, Gll^Fp, Gll^Fmw, Re^Fmw, Rb^Edt, Co, Rb^Es, Re, Re, Hhd^Qhux, Re, Hhd^Qhux, Hhd^Qhh, Mm^Qhh, Mm^Qhh, Hhd^Qhh, Hhd^Qhh
Mm^Qhh, Mm^Qhh, Mm^Qhh, Mm^Qhh, Hhd^Qhux, Hhd^Qhh, Hhd^Qhh, Hhd^Qhh, Hhd^Qhh, Re, Rb, Co, Rb^Edt, Sm, Sm, Hhd^Qhh, Hhd^Qhh, Hhd^Qhh, Re^Es, Hhd^Qhh, Re, Re, Sm^Qhu, Sm^Qhu, Sm^Qhu, Ko, Ko, Rb, Ko, Ko, Sm^Qhu, Sm^Qhu, Sm^Qhu, Sm^Qhu, Re, Gll^Fp, Gll^Fp, Gll^Fp, Rb, Rb^Es, Hhd^Qhh, Hhd^Qhh, Hhd^Qhh, Re, Rb, Hhd^Qhh, Hhd^Qhh, Mm^Qhh, Hhd^Qhh, Hhd^Qhh, Hhd^Qhh
Hhd^Qhh, Mm^Qhh, Mm^Qhh, Hhd^Qhux, Hhd^Qhux, Hhd^Qhux, Rb, Hhd^Qhh, Rb, Re, Rb, Rb, Re, Re, Re, Re^Edt, Re, Re^Es, Re, Re, Sm^Qhu, Sm^Qhu, Co, Co, Rb, Ko, Rb^Edt, Rb, Rb, Ko, Rb^Edt, Co, Co, Sm^Qhu, Sm^Qhu, Re, Sm^Qhu, Co, Rb, Re, Hhd^Qhh, Hhd^Qhh, Hhd^Dr, Rb, Co^Vo, Rb, Hhd^Qhh, Hhd^Qhh, Hhd^Qhh, Hhd^Qhh, Mm^Qhh
Hhd^Qhux, Mm^Qhh, Mm^Qhh, Hhd^Qhux, Sm, Hhd^Qhux, Rb, Rb^Vo, Rb^Edt, Rb, Co, Sm, Sm, Re, Hhd^Qhh, Re, Rb^Edt, Re, Re, Re, Sm^Qhu, Co, Rb, Rb^Vo, Re^Edt, Rb^Edt, Rb^Vo, Rb^Edt, Rb^Vo, Rb^Edt, Re, Rb^Vo, Rb, Co, Sm^Qhu, Sm^Qhu, Sm^Qhu, Hhd^Qhh, Re, Re^Es, Hhd^Qhh, Hhd^Qhh, Hhd^Dr, Co^Emf, Co^Em, Rb^Dr, Re, Hhd^Qhh, Hhd^Qhh, Mm^Qhh, Mm^Qhh
Hhd^Qhux, Hhd^Qhux, Hhd^Qhux, Hhd^Qhux, Hhd^Qhux, Re, Re, Hhd^Qhh, Re, Rb, Rb^Edt, Rb^Edt, Re, Re, Hhd^Qhh, Rb, Rb^Vo, Rb^Edt, Hhd^Qhh, Sm^Qhu, Ko, Ko, Rb, Re, Ko, Re, Re, Re, Re, Re, Ko, Re, Rb^Edt, Ko, Ko, Sm^Qhu, Hhd^Qhh, Hhd^Qhh, Re^Es, Hhd^Qhh, Hhd^Qhh, Hhd^Qhh, Rb, Co^Emf, Rb^Es, Rb, Re^Es, Hhd^Qhh, Hhd^Qhh, Mm^Qhh, Hhd^Qhux
Hhd^Qhux, Hhd^Qhux, Hhd^Qhux, Sm, Sm, Sm, Ko, Hhd^Qhh, Hhd^Qhh, Re, Re, Re, Hhd^Qhh, Re^Es, Hhd^Qhh, Hhd^Qhh, Hhd^Qhh, Hhd^Qhh, Hhd^Qhh, Sm^Qhu, Sm^Qhu, Ko, Rb^Edt, Re, Re, Co, Ko, Ko, Ko, Co, Re, Re, Re, Ko, Re, Sm^Qhu, Hhd^Qhh, Hhd^Qhh, Hhd^Qhh, Re^Es, Re^Dr, Re^Es, Re, Rb^Es, Rb^Es, Rb, Rb, Hhd^Qhux, Hhd^Qhux, Hhd^Qhux, Re
Hhd^Qhh, Hhd^Qhux, Hhd^Qhux, Sm, Hhd^Qhh, Hhd^Qhh, Hhd^Qhh, Hhd^Qhh, Hhd^Qhh, Rb^Edt, Rb^Edt, Re, Re^Es, Hhd^Qhh, Hhd^Qhh, Ko, Hhd^Qhh, Ko, Hhd^Qhh, Hhd^Qhh, Sm^Qhu, Rb, Rb^Edt, Rb^Vo, Re, Co, Ko, 2 Ko, Ko, Co, Re, Rb^Vo, Rb^Edt, Re, Rb, Re, Re^Es, Hhd^Qhh, Hhd^Qhh, Re^Vo, Re^Dr, Re^Dr, Re^Es, Rb, Co^Vo, Co^Em, Sm, Hhd^Qhux, Re^Es, Re, Hhd^Qhux
Hhd^Qhh, Hhd^Qhh, Re, Hhd^Qhh, Re, Hhd^Qhh, Hhd^Qhh, Ko, Hhd^Qhh, Rb^Vo, Rb^Edt, Re, Re, Hhd^Qhh, Hhd^Qhh, Hhd^Qhh, Rb^Vo, Hhd^Qhh, Re, Sm^Qhu, Ko, Ko, Rb, Re^Edt, Ko, Co, Co, Ko, Co, Co, Ko, Re^Edt, Rb^Edt, Ko, Ko, Sm^Qhu, Re, Hhd^Qhh, Re^Edt, Re^Es, Hhd^Qhh, Hhd^Qhh, Re^Es, Rb^Edt, Rb^Es, Co^Emf, Sm, Re^Edt, Rb^Es, Hhd^Qhux, Hhd^Qhux
Hhd^Qhh, Hhd^Qhh, Re^Es, Sm, Gd, Re^Es, Re, Hhd^Qhh, Hhd^Qhh, Hhd^Qhh, Hhd^Qhh, Re, Re, Re^Es, Hhd^Qhh, Hhd^Qhh, Hhd^Qhh, Rb, Re, Sm^Qhu, Sm^Qhu, Ko, Rb, Re^Edt, Re, Re, Rb^Vo, Co, Rb^Vo, Re, Re, Re^Edt, Rb, Ko, Sm^Qhu, Sm^Qhu, Sm^Qhu, Re, Re, Rb, Co, Hhd^Qhh, Co, Rb^Dr, Re^Es, Sm, Re, Rb^Edt, Rb^Vo, Rb^Dr, Hhd^Dr
Re, Hhd^Qhh, Gd, Gd, Sm, Gd, Rb, Re, Rb, Rb, Co, Rb, Rb, Rb, Ko, Co, Co, Hhd^Qhh, Hhd^Qhh, Re, Sm^Qhu, Co, Co, Rb, Rb, Rb, Rb, Re, Rb, Rb, Rb, Rb, Co, Co, Sm^Qhu, Re, Re, Sm^Qhu, Hhd^Qhh, Hhd^Qhh, Hhd^Qhh, Hhd^Qhh, Hhd^Qhh, Rb^Dr, Sm^Bw|r, Sm, Hhd^Qhh, Rb, Hhd^Qhh, Rb^Dr, Hhd^Qhh
Gd, Gd, Gd, Gd, Hhd^Qhh, Rb^Es, Rb^Vo, Rb, Rb, Co, Co, Ko, Rb, Rb, Hhd^Qhh, Co, Rb, Hhd^Qhh, Re, Re, Re, Sm^Qhu, Sm^Qhu, Co, Sm^Qhu, Ko, Ko, Re, Ko, Ko, Sm^Qhu, Co, Sm^Qhu, Sm^Qhu, Re, Re, Re, Sm^Qhu, Hhd^Qhh, Hhd^Qhh, Rb^Vo, Hhd^Dr, Re^Dr, Re, Rb, Rb, Rb^Es, Hhd^Qhh, Hhd^Qhh, Hhd^Qhh, Hhd^Qhh
Gd, Gd, Re, Hhd^Qhh, Hhd^Qhh, Rb, Rb^Edt, Rb^Edt, Re, Hhd^Qhh, Hhd^Qhh, Rb, Rb, Hhd^Qhh, Hhd^Qhh, Rb, Rb^Vo, Rb, Re, Re, Gd, Re, Re, Sm^Qhu, Sm^Qhu, Ko, Sm^Qhu, Re, Sm^Qhu, Ko, Sm^Qhu, Sm^Qhu, Re, Re^Dr, Re^Dr, Re, Rb, Sm^Qhu, Hhd^Qhh, Rb, Rb^Es, Re^Dr, Re^Es, Re^Es, Rb^Edt, Rb^Vo, Rb, Hhd^Qhh, Hhd^Qhh, Hhd^Qhh, Hhd^Qhh
Gd, Gd, Re, Re, Hhd^Qhh, Hhd^Qhh, Hhd^Qhh, Re, Re, Hhd^Qhh, Rb, Rb^Vo, Rb^Edt, Hhd^Qhh, Re^Es, Rb, Rb, Rb, Hhd^Qhh, Rb, Gd, Re, Gd, Re, Re, Sm^Qhu, Re, Re, Re, Sm^Qhu, Re, Re, Re, Re^Dr, Gd, Rb, Rb^Vo, Rb, Rb, Co, Gd, Re, Re, Re, Re, Rb, Rb^Edt, Rb^Edt, Rb^Edt, Hhd^Qhh, Hhd^Qhh
Gd, Gd, Gd, Co, Co, Hhd^Qhh, Re, Re, Re, Re, Gd, Rb^Edt, Gd, Re, Re, Re, Re, Re, Hhd^Qhh, Co, Hhd^Qhh, Gd, Gd, Re, Re, Re, Re, Re, Re, Re, Rb, Rb, Rb, Gd, Gd, Rb, Rb, Rb, Re, Rb, Gd, Gd, Hhd^Qhh, Re^Es, Hhd^Qhh, Hhd^Qhh, Hhd^Qhh, Hhd^Qhh, Re, Re, Re
Gs, Gd, Gd, Gd, Gd, Hhd^Qhh, Re, Re, Hhd^Qhh, Rb, Rb, Gd, Gd, Re, Hhd^Qhh, Hhd^Qhh, Re, Re^Es, Hhd^Qhh, Hhd^Qhh, Re^Vo, Gd^Edt, Co, Hhd^Qhh, Re, Re, Co, Re^Dr, Re^Es, Re, Rb^Edt, Rb^Vo, Rb^Edt, Rb, Co, Hhd^Qhh, Hhd^Qhh, Co, Hhd, Re, Hhd^Qhh, Hhd^Qhh, Co^Emf, Hhd^Qhh, Co^Emf, Co, Co^Vo, Hhd^Qhh, Hhd^Qhh, Re, Re
Gs, Gs, Gs, Gd, Gd, Gd, Re, Hhd^Qhh, Hhd^Qhh, Rb^Vo, Rb^Edt, Gd, Re^Edt, Re, Hhd^Qhh, Hhd^Qhh, Rb, Re, Rb, Re, Gd^Edt, Gd^Edt, Hhd^Qhh, Hhd^Qhh, Re^Es, Re^Dr, Hhd^Dr, Hhd^Qhh, Hhd^Qhh, Gd, Gd, Rb^Edt, Re, Hhd^Qhh, Rb^Dr, Hhd^Qhh, Re^Dr, Re^Dr, Re^Es, Re, Hhd^Qhh, Co^Vo, Co^Emf, Hhd^Qhh, Hhd^Qhh, Hhd^Qhh, Hhd^Qhh, Rb^Edt, Re^Edt, Re, Rb
Gs, Gs, Gs, Gd, Gd, Re, Gd, Co, Co, Rb^Es, Re, Re^Edt, Re^Edt, Hhd^Qhh, Co^Vo, Co^Emf, Rb^Dr, Rb^Es, Co, Rb, Re, Re, Re, Re, Re^Es, Re^Dr, Re^Es, Hhd^Qhh, Gd, Gd, Gd, Re, Hhd^Qhh, Rb, Re, Rb^Es, Gd, Re^Es, Re, Rb, Co, Hhd^Qhh, Hhd^Qhh, Hhd^Qhh, Re^Edt, Hhd^Qhh, Re, Re^Edt, Re, Hhd^Qhux, Hhd^Qhh
Gs, Gs, Gs, Gs, Gs, Re, Gd, Gd, Hhd, Hhd, Hhd, Re, Hhd^Qhh, Hhd^Qhh, Rb, Co, Re^Dr, Rb^Dr, Rb^Es, Rb, Re^Vo, Re, Re^Es, Rb^Dr, Rb^Dr, Rb, Hhd^Qhh, Re, Re, Gd, Hhd^Qhh, Re, Rb^Dr, Rb^Dr, Rb^Es, Gd, Gd, Rb, Rb^Edt, Rb, Hhd^Qhh, Hhd^Qhh, Hhd^Qhh, Re, Re, Re, Gd, Hhd^Qhux, Hhd^Qhux, Hhd^Qhux, Hhd^Qhh
Ww, Ww, Wo, Ww, Ww, Re, Ww, Gd, Hhd, Hhd, Hhd, Co, Co, Hhd^Qhh, Re, Hhd, Re^Es, Re^Dr, Re, Re, Re, Re, Rb^Dr, Rb^Dr, Co^Emf, Co, Hhd^Qhh, Hhd^Qhh, Re, Gd, Hhd^Qhh, Hhd^Qhh, Rb^Dr, Rb^Vo, Rb, Gd, Rb^Edt, Co^Emf, Co^Emf, Rb^Edt, Re, Re, Re, Rb^Vo, Re, Gd, Gd, Hhd^Qhh, Hhd^Qhh, Hhd^Qhh, Hh^Qhh
Gs, Ww, Gs, Wo, Re^Edt, Wwf, Ww, Gd, Gd, Gd, Gd, Gd, Gd, Hhd^Qhh, Gd, Re, Hhd^Qhh, Rb, Rb, Rb, Rb, Re, Re^Es, Rb^Dr, Rb^Es, Co^Vo, Rb^Edt, Hhd^Qhh, Re, Re, Re, Re, Re, Rb^Es, Re, Re, Rb^Edt, Co^Vo, Hhd^Qhh, Rb, Rb^Edt, Hhd^Qhh, Hhd^Qhh, Re, Gd, Gd, Hhd^Qhh, Hhd^Qhh, Hh^Qhh, Hh^Qhh, Hh^Qhh
Gs, Gs, Gd, Gd^Vo, Re^Edt, Re, Wo, Ww, Ww, Gd, Gd, Gd, Gs, Gd, Gd, Hhd^Qhh, Gd, Co, Co, Co, Co, Hhd^Qhh, Hhd^Qhh, Re, Hhd^Qhh, Rb^Edt, Hhd^Qhh, Rb, Rb, Re^Edt, Rb, Rb, Rb, Hhd^Qhh, Hhd^Qhh, Re, Hhd^Qhh, Rb, Ko, Co, Co, Hhd^Qhh, Hhd^Qhh, Re, Re, Hhd^Qhh, Hhd^Qhh, Hhd^Qhh, Hhd^Qhh, Hh^Qhh, Hh^Qhh
Gs, Gs, Gg, Gd, Gs, Gs, Gs, Wo, Gs, Ww, Wwf, Gs, Gs, Gd, Gd, Gd, Gd, Gd, Gd, Gd, Gd, Gd, Gd, Gd, Gd, Hhd^Qhh, Co, Ko, Ko, Re, Ko, Ko, Co, Hhd^Qhh, Re, Re, Re, Hhd^Qhh, Re, Hhd^Qhh, Hhd^Qhh, Gd, Re, Re, Re, Re, Hhd^Qhh, Hhd^Qhh, Hhd^Qhh, Hh^Qhh, Hh^Qhh
Gll^Fp, Gs, Gll^Fp, Gs, Gs^Es, Gs, Gs, Gs, Gs, Wwf, Wwf, Gs, Gs, Gs, Ww, Gd, Wwf, Gd, Ww, Gd, Ww, Gd, Gd, Gd, Gd, Gd, Gd, Re, Re, Re, Re, Gd, Gd, Gd, Gd, Gd, Gd, Re, Gd, Hhd^Qhh, Hhd^Qhh, Gd, Gd, Gd, Gd, Gd, Gd^Edt, Gd, Gd, Hhd^Qhh, Hhd^Qhh
Hh^Fp, Gll^Fp, Gll^Fdf, Gll^Fmf, Gll^Fmf, Gll^Fp, Gll^Fdf, Gll^Fp, Gs, Gs, Ww, Ww, Ww, Ww, Ww, Ww, Wwf, Wwf, Wwf, Ww, Wo, Ww, Ww, Gd, Gs, Gd, Gs, Gd, Re, Re^Es, Re, Gd, Gd, Gd, Gd, Gd, Gd, Gd, Gd, Gd, Gd, Gd, Gs, Gs, Gs, Gs, Gd^Edt, Gd^Vo, Gll^Qhuf, Hhd^Qhh, Hhd^Qhh
Hh^Fp, Re^Fp, Gll^Fp, Gll^Fp, Gll^Fmf, Gll^Fp, Gll^Fp, Gll^Fdf, Gll^Fp, Gs, Gs, Wo, Wo, Wo, Gs, Gs, Gll^Fp, Re, Re, Re^Vo, Gd^Edt, Wo, Wo, Gs, Gs, Gs, Gs, Gs, Re, Re, Re, Gs, Gd^Edt, Gd^Vo, Gd^Edt, Gs, Gs, Gd^Edt, Gd^Vo, Gd, Gs, Gs, Gs, Hhd, Hhd, Hhd, Hhd, Gll^Qhuf, Gll^Fdf, Gll^Qhuf, Hhd^Qhh
Gll^Fmw, Gll^Fp, Gll^Fmf, Gll^Fp, Gll^Fp, Gll^Fp, Gll^Fmf, Gll^Fdf, Gll^Fp, Gll^Fp, Hhd^Fp, Re^Fp, Gs, Gs, Gs, Gll^Fp, Gll^Fp, Gll^Fmw, Gll^Fmw, Re^Edt, Gs, Gs, Wo, Ww, Gs^Edt, Gd, Gd, Gs, Gs, Re, Re, Re, Re, Gd, Gs, Gs, Gs, Gd, Gd, Gs^Edt, Gs, Gs, Gs, Hhd, Gs, Hhd, Hhd, Hh, Hh, Gll^Qhuf, Hhd^Qhh
Hh, Hh^Fp, Gll^Fp, Gll^Fp, Gll^Fp, Gll^Fp, Gll^Fmf, Gll^Fp, Gll^Fp, Gll^Fp, Gll^Fp, Gd^Em, Gd, Gd, Gd^Edt, Gll^Fp, Re, Gll^Fp, Re, Re, Re, Ww, Wwf, Ww, Gs^Edt, Gd^Vo, Gd, Gs, Gs, Gd^Edt, Re, Re^Es, Re, Gs, Gs, Gs, Gs, Gll^Qhuf, Gll^Qhuf, Gll^Fmf, Gll^Fmf, Gs, Gd^Edt, Gd, Gd, Gll^Fp, Hh, Gll^Qhuf, Gll^Qhuf, Re^Qhuf, Hhd^Qhh
Hh, Hh, Gll^Fp, Gll^Fp, Gll^Fmf, Gll^Fp, Gll^Fp, Gll^Fmf, Gll^Fp, Gll^Fp, Gll^Fp, Gll^Fdf, Gll^Fp, Gd^Vo, Re, Re, Gs, Re, Gs, Gs, Ww, Wwf, Re, Gs, Gs^Edt, Gs^Edt, Gs, Gd, Gs, Gs, Gs, Re^Es, Re^Es, Re, Gs, Gd, Gs, Gll^Qhuf, Gll^Fmf, Gll^Qhuf, Gll^Qhuf, Gs, Gd, Gd^Vo, Gll^Qhuf, Hh, Hh, Gll^Qhuf, Gll^Qhuf, Gll^Qhuf, Gll^Qhuf
Hh, Hh, Hh, Hh, Gll^Fp, Gll^Fp, Gll^Fp, Gll^Fmf, Wwg, Gll^Fmf, Wwg, Gll^Fp, Ww, Re, Ww, Gs, Ww, Wwg, Wo, Wwg, Wwg, Wwf, Gs, Re, Gs, Gs, Gs, Gs, Gs, Gs, Gs, Re, Re^Es, Re, Gd^Es, Gs^Es, Hh, Gs, Hh, Gll^Qhuf, Hh, Gll^Qhuf, Gll^Qhuf, Hhd, Gll^Qhuf, Gll^Qhuf, Hh, Hh, Gll^Qhuf, Gll^Qhuf, Gll^Qhuf
Hh, Hh, Hh, Hh, Hh, Hh, Hh, Gll^Fp, Ww, Wwg, Wo, Wo, Wo, Wwg^Bw|r, Wo, Wo, Wo, Wo, Wo, Wwg, Gs, Gs, Gs, Re, Re, Gs, Gs, Gs, Gs, Gs, Gs, Re, Re, Re, Gs, Gll^Fmf, Gll^Fp, Hh, Hh, Hh, Hh, Gll^Qhuf, Gll^Qhuf, Gll^Qhuf, Hh, Gll^Fdf, Hh, Hh^Fp, Hh^Fp, Gll^Fdf, Gll^Fmf
Hh, Hh, Wwr, Ww, Ww, Ww, Ww, Ww, Gll^Fp, Wo, Wo, Wo, Wo, Wo, Wo, Wo, Wwg, Ww, Gs, Wwg, Gs, Gs, Gll^Fp, Gs, Gd, Re, Re, Gs, Co, Co, Co, Re, Re, Re, Gll^Qhuf, Gll^Fmf, Hh, Hh, Hh, Hh, Gll^Fdf, Hh, Gll^Qhuf, Gll^Qhuf, Gll^Qhuf, Hh, Hh, Hh^Fp, Hh, Hh, Hh
Hh, Hh, Hh, Hh, Hh, Hh, Hh, Hh, Gll^Fp, Gll^Fp, Ww, Ww, Gll^Fmf, Ww, Gll^Fmf, Wo, Hh, Gs, Hh, Gs, Gll^Qhuf, Gll^Qhuf, Gs^Em, Gs, Re, Gs, Re, Re, Re, Re, Re, Re, Re, Re, Re, Gll^Qhuf, Gll^Fdf, Hh^Fp, Hh^Fp, Hh, Hh, Gll^Fmf, Gll^Qhuf, Gll^Fmf, Hh^Fp, Hh, Hh, Hh, Hh, Hh, Hh
Hh, Hh, Hh, Hh, Hh, Hh, Hh, Hh, Ww, Ww, Gll^Fp, Gll^Fmf, Gll^Fdf, Gll^Fmf, Gll^Fdf, Wo, Wo, Hh, Hh, Gll^Qhuf, Gll^Qhuf, Gll^Qhuf, Hh, Gll^Fdf, Gll^Fdf, Re, Co^Ecf, Co^Vct, Co, Co, Co, Co^Vct, Co^Ecf, Re, Re, Gll^Qhuf, Gll^Qhuf, Gll^Fdf, Gll^Qhuf, Hh, Hh, Hh, Hh, Hh^Fp, Hh, Hh, Hh^Fp, Hh, Hh, Hh, Hh
Hh, Hh, Hh, Hh, Wwr, Ww, Ww, Ww, Hh, Hh, Hh, Gll^Fmf, Gll^Fmf, Gll^Fmf, Gll^Fp, Hh, Ww, Hh, Hh, Gll^Fmf, Hh, Hh, Hh, Gll^Qhuf, Gll^Fdf, Re, Re, Co^Vct, Co, 1 Ko, Co, Co^Vct, Rb^Edt, Rb, Re^Edt, Re, Hh, Gll^Qhuf, Hh, Hh, Hh, Hh, Hh, Hh, Hh, Hh, Hh^Fp, Gll^Fmf, Gll^Fmf, Gll^Qhuf, Gll^Fmf
Hh, Hh, Hh, Hh, Hh, Hh, Hh, Hh, Hh, Hh, Hh, Gll^Fmf, Hh, Gll^Fdf, Hh, Ww, Hh, Hh, Hh, Hh, Hh, Gll^Qhuf, Gll^Qhuf, Gll^Fdf, Gll^Qhuf, Re, Re, Rb, Rb, Rb, Rb, Rb^Edt, Rb^Edt, Rb^Edt, Re^Edt, Re, Hh, Hh, Hh^Fp, Hh, Hh, Hh, Hh^Fp, Hh^Fp, Gll^Fmf, Hh, Hh, Gll^Qhuf, Gll^Qhuf, Gll^Qhuf, Gll^Qhuf
Hh, Hh^_mh, Hh, Hh, Hh, Hh, Hh, Hh, Hh, Hh, Hh, Hh, Hh, Hh, Hh, Wwr, Hh, Hh, Hh, Hh, Hh, Gll^Qhuf, Gll^Fmf, Gll^Qhuf, Gll^Fmf, Gll^Fdf, Gll^Qhuf, Gll^Qhuf, Gll^Qhuf, Rb, Rb^Em, Rb^Edt, Rb, Rb^Edt, Re, Gll^Fmf, Gll^Qhuf, Gll^Qhuf, Gll^Fdf, Gll^Qhuf, Gll^Qhuf, Hh, Hh, Gll^Qhuf, Gll^Qhuf, Hh, Hh, Hh, Hh, Gll^Qhuf, Gll^Qhuf
Hh, Hh, Hh, Hh, Hh, Hh, Hh, Hh, Hh, Hh, Hh, Hh, Gs, Hh, Hh, Hh, Hh, Hh, Hh, Hh, Hh, Hh, Hh, Hh, Gll^Qhuf, Gll^Qhuf, Gll^Qhuf, Gll^Qhuf, Gll^Qhuf, Gll^Qhuf, Rb, Rb, Rb, Rb^Edt, Re, Gll^Qhuf, Hh, Gll^Qhuf, Gll^Qhuf, Gll^Qhuf, Gll^Fmf, Hh, Gs, Gll^Fmf, Gll^Fmf, Gll^Qhuf, Gll^Qhuf, Hh, Hh, Gll^Qhuf, Gll^Qhuf
