Ms, Ms, Ms, Ms, Ms, Ms, Ms, Ms, Ms^Xm, Ms^Xm, Ms^Xm, Ms^Xm, Ms^Xm, Ms^Xm, Ms, Hhd, Ms, Hhd, Re, Ms, Ms, Ms, Ms, Ms^Xm, Ms^Xm, Ms^Xm, Ms^Xm, Ms^Xm, Ms^Xm, Ms^Xm, Ms^Xm, Ms^Xm, Ms^Xm
Gd, Ms, Aa, Ms, Ha, Ha, Ha, Ms, Ms, Ms, Ms, Ms, Ha, Ms, Ha, Ms, Coa, Ms, Re, Gd^Es, Ms, Ms, Ms, Ms^Xm, Ms^Xm, Ms^Xm, Ms, Ms^Xm, Ms, Ms, Ms^Xm, Ms^Xm, Ms
Re, Re^Es, Re, Aa, Coa, Ha, Ha, Ms, Ha, Ms, Hhd^Esa, Aa, Aa^Esa, Aa, Hhd, Ha, Ha, Gd^Es, Re^Esa, Coa, Ha, Ms, Ms, Ms^Xm, Ms, Ms, Ha^Fma, Ha^Fma, Ms, Ms, Ms^Xm, Ms^Xm, Ms
Ms, Ms, Aa, Re, Gd^Esa, Aa, Aa^Esa, Ha, Ha, Ha, Gd^Esa, Hhd^Esa, Re^Es, Hhd^Esa, Re^Vo, Ha, Re^Esa, Re, Aa, Ha, Ha, Ms, Ms, Ms^Xm, Ms, Ha^Fma, Ha^Fma, Ms, Ms, Ms^Xm, Ms, Ms, Ha
Ms, Ms, Coa, Re, Re^Es, Re^Esa, Re, Aa, Re^Esa, Hhd, Re, Re^Edt, Rb^Edt, Re^Edt, Re^Edt, Re, Re^Edt, Re^Esa, Aa, Hhd, Hhd, Ms, Ha, Ms, Ms, Ha^Fma, Aa^Fma, Ha^Fma, Ms, Ms, Ms, Ms, Ha
Ms^Xm, Ms^Xm, Ms, Ha, Ha, Gd^Dr, Aa, Gd^Edt, Re^Edt, Re^Vo, Rb, Rb^Edt, Co^Edt, Rb^Edt, Rb, Re, Re, Gd^Es, Gd^Es, Gd^Dr, Ha, Ha, Ms, Ms, Ms, Ha^Fma, Aa^Esa, Ha, Ai, Ai, Ms, Ha, Ha
Ms^Xm, Ms^Xm, Ms, Ms, Ha, Hhd^Esa, Hhd^Esa, Gd^Edt, Re^Edt, Rb, 2 Ko, Co^Edt, Co^Edt, Co^Edt, Ko, Rb, Re^Edt, Re^Vo, Re, Aa, Aa^Esa, Ha, Ha, Ms, Ha, Ha^Fma, Aa^Esa, Ai^Esa, Wwg, Hhd, Hhd, Ha, Ha
Ms^Xm, Ms^Xm, Ms, Ha, Aa, Aa, Aa, Gd^Esa, Re, Rb, Rb, Co^Edt, Co^Edt, Co^Edt, Rb^Edt, Rb, Rd, Re^Edt, Re^Edt, Gd^Esa, Aa, Ha, Ha, Ms, Ha, Ha, Ai, Ai, Wwg, Hhd, Aa, Ha, Aa
Ha, Ms, Ms, Ha, Ha, Ha, Aa, Re, Re^Vo, Gd^Es, Rb, Ko, Ko, Ko, Rb^Edt, Rd, Rd, Rd, Re^Edt, Re^Vo, Re^Esa, Aa, Hhd^Esa, Ha, Hhd^Esa, Ha, Wwrg, Wwg, Ai, Gd^Esa, Gd^Dr, Aa^Esa, Gd
Ha, Ms, Ms, Ms, Ha, Hhd^Esa, Hhd, Re^Es, Re^Es, Re^Esa, Aa, Rb, Rb, Rb^Edt, Re, Rd, Rd, Rd, Re^Esa, Re, Re, Re, Aa, Coa, Aa, Gd^Esa, Ai, Wwg, Aa, Gd^Esa, Re^Es, Gd^Esa, Re
Ha, Ms, Ha, Ha, Ha, Aa, Hhd, Re^Es, Re^Esa, Aa, Aa^Edt, Aa, Gd^Esa, Re, Re^Vo, Re^Edt, Re, Re, Aa, Aa, Gd^Esa, Re, Rb, Aa, Re, Gd, Wwg, Wwg, Aa, Re^Esa, Gd^Es, Re^Es, Gd
Ha, Ha, Mm, Ha, Ha, Hhd^Vo, Hhd, Hhd, Rb^Es, Gd^Edt, Gd^Edt, Gd^Edt, Gd, Aa, Re, Re, Gd, Re^Vo, Gd, Gd, Rb^Es, Co, Rb, Re^Es, Gd, Wwg^Bp\, Re, Aa, Re^Es, Re, Gd, Gd^Edt, Hhd
Mm, Mm, Mm, Ha, Ha, Ha, Hhd, Ha, Rb, Co, Rb^Es, Re, Rb, Gd, Rb, Re^Es, Gd^Es, Gd, Rb, Co, Rb, Rb^Es, Gd, Gd, Wwg, Wwg, Ai, Re, Wwf, Gd^Vo, Hhd, Ha, Ha
Hhd, Mm, Hhd, Mm, Ha, Hhd^Esa, Hhd, Hhd, Gd^Dr, Rb, Gd^Esa, Aa, Aa, Co, Rb, Co, Rb, Re, Gd, Rb, Gd^Dr, Re, Aa, Gd^Esa, Wwg, Wwg, Wwf, Wwf, Wwrg, Wwf, Wwf, Ha, Hhd
Hhd, Hhd, Hhd, Mm, Mm, Ha, Hhd, Hhd, Hhd, Gd, Gd, Aa, Gd, Rb, Gd, Rb, Gd, Gd, Gd^Fp, Gd^Fp, Gll^Es, Gd, Gd, Wwg, Wwg, Wwrg, Gd^Edt, Hhd^Edt, Hhd^Edt, Ha, Wwf, Hhd, Mm
Hhd^Fma, Hhd, Hhd, Mm, Mm, Mm, Hhd, Hhd, Mm, Hhd, Gd^Vo, Gd, Gd^Es, Gll^Es, Gll^Es, Re, Gd, Gd, Gd^Fp, Gll^Fp, Gll, Gd^Es, Wwg, Wwf, Gd^Fmw, Gd^Vo, Hhd^Edt, Chr^Edt, Hhd^Edt, Hhd, Mm, Mm, Mm
Mm, Mm, Ai, Wwrg, Ai, Mm, Hhd, Mm, Mm, Hhd, Gd^Fmw, Gd^Fmw, Gd, Gll^Es, Re, Re, Gd^Fmw, Gd, Gd, Gd^Vo, Gd, Gd, Wwg, Wwg, Uh^Fp, Gd^Fmw, Hhd, Hhd^Edt, Mm, Mm, Mm, Mm, Mm
Hhd, Mm, Chr^Fmw, Wwg, Wwg, Ha, Hhd^Fmw, Hhd, Hhd, Hhd, Gd, Gd^Fmw, Gd, Re, Gd, Gll, Gd, Gll, Gd, Gd, Gll, Gd, Wwg, Wwrg, Uh^Fp, Gll^Fmw, Re, Hhd, Chr^Edt, Khr, Hhd, Mm, Mm
Hhd, Hhd, Chr, Chr, Wwrg, Wwg, Hhd^Fmw, Hhd^Fmw, Hhd^Fmw, Gd, Gll^Fmw, Gll, Gll^Fmw, Re, Gll, Gll^Fmf, Gll^Fmw, Gll^Fmw, Gll^Fmw, Gll^Fmw, Gll^Fmw, Wwg, Wwg, Uh^Fp, Uh^Fp, Hhd, Hhd, Chr^Edt, Chr^Edt, Chr^Edt, Hhd, Hhd, Mm
Hhd, Hhd^Fmw, Khr, Ai, Hhd^Fmw, Wwg, Gll^Fmw, Gll^Fmf, Gll^Fmw, Gll, Gll^Fmw, Rb, Gll^Vo, Gll^Fmw, Gll^Fmw, Gll^Fmw, Gll^Fmf, Rb, Rb, Gll^Fmw, Wwg, Wwg, Uh^Fp, Uh^Fp, Uh^Fp, Uh^Fp, Gll^Fmw, Re^Edb, Re^Edb, Re^Edb, Hhd^Vo, Mm, Hhd
Hhd^Fmw, Hhd^Fmw, Gll^Em, Hhd^Fmw, Gll^Fmw, Wwg, Gll^Feth, Gll^Fmf, Uh^Fp, Gll^Fmw, Rb, Rb^Es, Gll^Em, Gll^Fmw, Uh^Fp, Gll^Fmw, Gll^Fmf, Gll^Fmw, Rb^Es, Gll^Em, Gll^Fdw, Wwg, Wwg, Uh^Fp, Gll^Fmw, Uh^Fp, Rb^Es, Gd, Rb^Es, Hhd, Gd^Edt, Hhd, Hhd
Gll^Fmf, Gll^Fmw, Gll^Vo, Hhd^Fmw, Wwg, Wwrg, Uh^Fp, Uh^Fp, Uh^Fp, Uh^Fp, Uh^Fp, Gll^Es, Gll^Fmw, Uh^Fp, Uh^Fp, Uh^Fp, Uh^Fp, Uh^Fp, Uh^Fp, Gll^Fmw, Gll^Vo, Wwrg, Wwg, Gll^Fmw, Gll^Fmw, Gll^Fmw, Rb^Es, Gll^Fmw, Gll^Fmw, Gll^Fmw, Gll^Fmw, Gd, Gd
Uh^Fp, Gll^Fmw, Uh^Fp, Gll^Fmw, Wwg, Uh^Fp, Uh^Fp, Uh^Fp, Uh^Fp, Uh^Fp, Uh^Fp, Gll^Fmw, Rb^Es, Uh^Fp, Uh^Fp, Uh^Fp, Uh^Fp, Uh^Fp, Uh^Fp, Uh^Fp, Gll^Em, Gll^Fmw, Wwf, Wwf, Gll^Fmw, Rb^Es, Gll^Fmw, Gll^Vo, Uh^Fp, Uh^Fp, Uh^Fp, Uh^Fp, Uh^Fp
Uh^Fp, Uh^Fp, Uh^Fp, Gll^Fmw, Wwg, Uh^Fp, Uh^Fp, Uh^Fp, Uh^Fp, Uh^Fp, Uh^Fp, Uh^Fp, Rb^Fdw, Gll^Fmw, Gll^Vo, Uh^Fp, Uh^Fp, Uh^Fp, Uh^Fp, Uh^Fp, Rb^Em, Gll^Fmf, Gll^Fmw, Wwf, Wwrg, Gll^Fmw, Gll^Fmw, Gll^Fmw, Uh^Fp, Uh^Fp, Uh^Fp, Uh^Fp, Uh^Fp
Uh^Fp, Uh^Fp, Uh^Fp, Uh^Fp, Rb, Wwg, Uh^Fp, Uh^Fp, Uh^Fp, Uh^Fp, Uh^Fp, Uh^Fp, Rb^Es, Gll^Fmf, Rb, Rb^Es, Rb^Es, Gll^Fmw, Gll^Fmw, Rb^Es, Uh^Fp, Rb, Gll^Fmw, Wwg, Wog, Wwg, Wwg, Gll^Fmw, Wwg, Uh^Fp, Ss, Uh^Fp, Wwg
Gll^Fdw, Uh^Fp, Gll, Uh^Fp, Rb^Es, Wwrg, Wwg, Uh^Fp, Wwg, Uh^Fp, Wwg, Gll^Fmw, Rb, Uh^Fp, Uh^Fp, Uh^Fp, Uh^Fp, Uh^Fp, Uh^Fp, Uh^Fp, Uh^Fp, Uh^Fp, Wwg, Wog, Wwg^Bp|, Wog, Wog, Wog, Wog, Wwg^Ewl, Wog, Wwg, Wog
Gll^Fmw, Gll^Fmf, Gll^Fmf, Rb^Es, Gll^Fmw, Gll^Vo, Rb, Wwg, Rb^Es, Wwg, Gll^Fmf, 3 Wwrg, Wwf, Uh^Fp, Wwg, Uh^Fp, Wwg, Uh^Fp, Wwg, Wwg, Wwg, Wwg, Gll^Fmf, Wwg, Gll^Vo, Wwg, Ss, Wwg^Ewl, Ss, Wog, Wwg^Ewl, Wog, Ss
Uh^Fp, Uh^Fp, Uh^Fp, Uh^Fp, Uh^Fp, Gll^Fmw, Uh^Fp, Gll^Fmw, Uh^Fp, Gll^Fmw, Uh^Fp, Gll^Fmw, Rb^Es, Wwrg, Gll^Fmw, Wwg, Uh^Fp, Wwg, Uh^Fp, Gll^Fmf, Uh^Fp, Uh^Fp, Uh^Fp, Uh^Fp, Uh^Fp, Gll^Fmw, Gll^Fmw, Gll, Gll^Fmf, Gll^Fmw, Gll^Fmw, Ss, Gll^Fmw
Uh^Fp, Uh^Fp, Uh^Fp, Uh^Fp, Uh^Fp, Uh^Fp, Uh^Fp, Uh^Fp, Uh^Fp, Uh^Fp, Uh^Fp, Uh^Fp, Rb^Es, Gll^Vo, Gll^Fmf, Uh^Fp, Uh^Fp, Uh^Fp, Uh^Fp, Uh^Fp, Uh^Fp, Uh^Fp, Uh^Fp, Uh^Fp, Uh^Fp, Gll^Fdw, Gll^Fmf, Gll^Fmf, Gll^Fmw, Gll^Fmw, Gll^Fmw, Gll^Fmw, Gll^Fmw
Gll^Fmw, Uh^Fp, Uh^Fp, Uh^Fp, Uh^Fp, Uh^Fp, Uh^Fp, Uh^Fp, Gll^Fmw, Uh^Fp, Gll^Fmw, Uh^Fp, Gll^Fmw, Rb, Gll^Fmw, Uh^Fp, Gll^Fmf, Gll^Fmw, Gll^Fmf, Uh^Fp, Gll^Fmw, Uh^Fp, Gll^Fmw, Uh^Fp, Rb^Es, Gll^Fmw, Gll^Fmw, Gll^Feth, Gll^Es, Gll^Fmw, Uh^Fp, Uh^Fp, Uh^Fp
Gll^Fmw, Gll^Fmw, Gll^Fmw, Gll^Vo, Rb^Es, Gll^Fmw, Gll^Fmw, Gll^Fmw, Gll^Fmw, Gll^Fmw, Gll^Fmf, Gll^Fmw, Gll^Fdw, Gll^Fdw, Gll^Fmf, Gll^Fmf, Rb^Es, Gll^Fmw, Gll^Fmw, Gll^Fmw, Gll^Fdw, Gll^Fmw, Gll^Fmw, Rb, Gll^Fmf, Rb, Gll^Vo, Rb^Es, Uh^Fp, Uh^Fp, Uh^Fp, Uh^Fp, Uh^Fp
Uh^Fp, Gll^Fmw, Gll^Em, Rb^Es, Gll^Fmw, Rb^Em, Gll^Fmw, Gll^Fmw, Uh^Fp, Uh^Fp, Uh^Fp, Gll^Fmw, Uh^Fp, Gll^Fmw, Uh^Fp, Gll^Fmw, Rb^Es, Gll^Vo, Uh^Fp, Uh^Fp, Uh^Fp, Uh^Fp, Uh^Fp, Uh^Fp, Uh^Fp, Uh^Fp, Gll, Gll^Fmw, Gll^Fmw, Uh^Fp, Uh^Fp, Uh^Fp, Uh^Fp
Uh^Fp, Uh^Fp, Uh^Fp, Uh^Fp, Gll^Em, Gll^Fmw, Uh^Fp, Gll^Fmw, Uh^Fp, Uh^Fp, Uh^Fp, Uh^Fp, Uh^Fp, Uh^Fp, Gll^Fmw, Gll^Fmw, Gll^Fmw, Rb, Uh^Fp, Uh^Fp, Uh^Fp, Uh^Fp, Uh^Fp, Uh^Fp, Uh^Fp, Uh^Fp, Gll^Fmw, Gll^Fmw, Gll^Fmw, Gll^Fmw, Gll^Fdw, Uh^Fp, Gll^Fmw
Uh^Fp, Uh^Fp, Uh^Fp, Uh^Fp, Gll^Fdw, Gll^Feth, Uh^Fp, Uh^Fp, Uh^Fp, Uh^Fp, Uh^Fp, Uh^Fp, Uh^Fp, Uh^Fp, Gll^Fmw, Gll^Fmw, Gll^Fmw, Gll^Fmw, Gll^Fmw, Uh^Fp, Gll^Fmw, Gll^Fmw, Gll^Fmw, Gll^Fmw, Gll^Em, Rb^Es, Gll^Fmw, Gll^Fmw, Gll^Fmf, Gll^Fdw, Gll^Fmw, Gll^Fmw, Gll^Fdw
Uh^Fp, Uh^Fp, Uh^Fp, Uh^Fp, Uh^Fp, Gll^Fmw, Gll^Fmw, Uh^Fp, Uh^Fp, Uh^Fp, Gll^Fmf, Uh^Fp, Rb, Rb^Es, Rb^Es, Gll, Gll^Vo, Rb, Gll^Fmw, Gll^Fmw, Gll^Fdw, Gll^Fdw, Gll^Fmw, Gll^Fmw, Gll^Fmw, Gll^Fmf, Gll^Fmw, Gll^Fmw, Gll^Fdw, Gll^Fmf, Gll, Gll^Fmw, Gd
Gll^Fmw, Uh^Fp, Gll^Fmw, Uh^Fp, Gll^Fmw, Gll^Fmf, Gll^Fmw, Gll^Vo, Gll^Em, Gll^Fdw, Gll^Fmw, Gll^Fmw, Gll^Fmw, Gll^Fmf, Gll^Fdw, Gll^Fmw, Gll^Fmf, Gll, Rb, Gll^Fmw, Re, Re, Re, Gll^Fmw, Gd, Gll^Fmf, Gd, Gll^Fdw, Gd, Gll, Rd^Es, Gll, Gd
Hhd, Gll^Fdw, Gll^Fmw, Gll^Fmf, Gll^Fmf, Gll^Fmf, Hhd, Gll, Hhd, Gll^Fmf, Hhd, Gll^Fmw, Gll^Em, Gll^Fdw, Gll^Fmw, Gll^Fmw, Gll, Gll^Fmw, Gd, Re, Co, Co, Co, Re, Gd, Gll, Rd, Gd, Gd^Vo, Rd^Es, Rd^Dr, Rd^Es, Gd
Mm, Hhd, Mm, Hhd, Mm, Mm, Mm, Mm, Hhd, Hhd, Hhd, Gll^Fmf, Gll^Fmw, Gll^Fmw, Hhd, Gll^Fmw, Rd, Gll, Gd, Re, Co, 1 Ko, Co, Re, Gd^Edt, Gd^Edt, Rd^Es, Rd, Gd, Rd^Es, Rd^Es, Rd^Es, Gd
Mm, Mm, Mm, Mm, Mm, Mm, Mm, Mm, Mm, Mm, Hhd, Hhd, Hhd, Hhd^Vo, Hhd, Hhd, Rd^Es, Rd^Es, Rd^Es, Re, Re, Co, Re, Re, Gll, Rd^Es, Rd^Dr, Rd^Es, Gd^Edt, Rd, Gd, Gd, Gd
Mm, Mm, Mm, Mm, Mm, Mm, Mm, Mm, Mm, Mm, Mm, Mm, Mm, Hhd, Hhd, Rd, Rd^Es, Rd^Dr, Rd^Es, Gd, Gd, Re, Re, Gd, Rd, Rd^Es, Rd^Es, Rd^Es, Rd, Gd, Gd, Gd^Edt, Gd
Mm, Mm, Mm, Mm, Mm, Mm, Mm, Mm, Mm, Mm, Mm, Mm, Mm, Mm, Hhd, Hhd, Hhd, Rd^Es, Gd, Gd, Gd, Gd, Re, Re, Gd, Gd, Gd, Gd, Gd, Gd, Gd, Gd, Gd
