Ms, Ms, Ms, Ms, Ms, Ms, Ms, Ms, Ms^Xm, Ms^Xm, Ms^Xm, Ms^Xm, Ms^Xm, Ms^Xm, Ms, Hhd, Ms, Hhd, Re, Ms, Ms, Ms, Ms, Ms^Xm, Ms^Xm, Ms^Xm, Ms^Xm, Ms^Xm, Ms^Xm, Ms^Xm, Ms^Xm, Ms^Xm, Ms^Xm
Gd, Ms, Aa, Ms, Ha, Ha, Ha, Ms, Ms, Ms, Ms, Ms, Ha, Ms, Ha, Ms, Coa, Ms, Re, Gd^Es, Ms, Ms, Ms, Ms^Xm, Ms^Xm, Ms^Xm, Ms, Ms^Xm, Ms, Ms, Ms^Xm, Ms^Xm, Ms
Re, Re^Es, Re, Aa, Coa, Ha, Ha, Ms, Ha, Ms, Hhd^Esa, Aa, Aa, Aa, Hhd, Ha, Ha, Gd^Es, Re, Coa, Ha, Ms, Ms, Ms^Xm, Ms, Ms, Ha, Ha, Ms, Ms, Ms^Xm, Ms^Xm, Ms
Ms, Ms, Aa, Re, Gd^Esa, Aa, Aa, Ha, Ha, Ha, Gd^Esa, Hhd^Esa, Re^Es, Hhd^Esa, Re^Vo, Ha, Re^Esa, Re, Aa, Ha, Ha, Ms, Ms, Ms^Xm, Ms, Ha, Ha, Ms, Ms, Ms^Xm, Ms, Ms, Ha
Ms, Ms, Coa, Re, Re^Es, Re, Re, Aa, Re, Hhd, Re, Re^Edt, Re^Edt, Re^Edt, Re^Edt, Re, Re^Edt, Re, Aa, Hhd, Hhd, Ms, Ha, Ms, Ms, Ha, Aa, Ha, Ms, Ms, Ms, Ms, Ha
Ms^Xm, Ms^Xm, Ms, Ha, Ha, Gd^Dr, Aa, Gd^Edt, Re^Edt, Re^Vo, Re, Re^Edt, Co, Re^Edt, Re, Re, Re, Gd^Es, Gd^Es, Gd^Dr, Ha, Ha, Ms, Ms, Ms, Ha, Aa, Ha, Ai, Ai, Ms, Ha, Ha
Ms^Xm, Ms^Xm, Ms, Ms, Ha, Hhd^Esa, Hhd^Esa, Gd^Edt, Re^Edt, Re, 2 Ko, Co, Co, Co, Ko, Re, Re^Edt, Re^Vo, Re, Aa, Aa, Ha, Ha, Ms, Ha, Ha, Aa, Ai, Wwg, Hhd, Hhd, Ha, Ha
Ms^Xm, Ms^Xm, Ms, Ha, Aa, Aa, Aa, Gd^Esa, Re, Re, Re, Co, Co, Co, Re^Edt, Re, Rd, Re^Edt, Re^Edt, Gd, Aa, Ha, Ha, Ms, Ha, Ha, Ai, Ai, Wwg, Hhd, Aa, Ha, Aa
Ha, Ms, Ms, Ha, Ha, Ha, Aa, Re, Re^Vo, Gd, Re, Ko, Ko, Ko, Re^Edt, Rd, Rd, Rd, Re^Edt, Re^Vo, Re, Aa, Hhd^Esa, Ha, Hhd^Esa, Ha, Gd, Wwg, Ai, Gd^Esa, Gd^Dr, Aa, Gd
Ha, Ms, Ms, Ms, Ha, Hhd^Esa, Hhd, Re, Re, Re, Aa, Re, Re, Re^Edt, Re, Rd, Rd, Rd, Re, Re, Re, Re, Aa, Coa, Aa, Gd^Esa, Ai, Wwg, Aa, Gd^Esa, Re^Es, Gd^Es, Re
Ha, Ms, Ha, Ha, Ha, Aa, Hhd, Re^Esa, Re^Esa, Aa, Aa^Edt, Aa, Gd, Re, Re^Vo, Re^Edt, Re, Re, Aa, Aa, Gd, Re, Re, Aa, Re, Gd, Wwg, Wwg, Aa, Re, Gd^Es, Re^Es, Gd
Ha, Ha, Mm, Ha, Ha, Hhd^Vo, Hhd, Hhd, Re^Es, Gd^Edt, Gd^Edt, Gd^Edt, Gd, Aa, Re, Re, Gd, Re^Vo, Gd, Gd, Re^Es, Co, Re, Re^Es, Gd, Wwg^Bp\, Re, Aa, Re^Es, Re, Gd, Gd^Edt, Hhd
Mm, Mm, Mm, Ha, Ha, Ha, Hhd, Ha, Re, Co, Re^Es, Re, Re, Gd, Re, Re^Es, Gd^Es, Gd, Re, Co, Re, Re^Es, Gd, Gd, Wwg, Wwg, Ai, Re, Wwf, Gd^Vo, Hhd, Ha, Ha
Hhd, Mm, Hhd, Mm, Ha, Hhd, Hhd, Hhd, Gd^Dr, Re, Gd, Aa, Aa, Co, Re, Co, Re, Re, Gd, Re, Gd^Dr, Gd, Aa, Gd, Wwg, Wwg, Wwf, Wwf, Hhd, Wwf, Wwf, Ha, Hhd
Hhd, Hhd, Hhd, Mm, Mm, Ha, Hhd, Hhd, Hhd, Gd, Gd, Aa, Gd, Re, Gd, Re, Gd, Gd, Gd^Es, Gd^Es, Gd^Es, Gd, Gd, Wwg, Wwg, Gd, Gd, Hhd, Hhd, Ha, Wwf, Hhd, Mm
Hhd^Fma, Hhd, Hhd, Mm, Mm, Mm, Hhd, Hhd^Fmw, Mm, Hhd, Gd^Vo, Gd, Gd^Es, Gd^Es, Gd^Es, Re, Gd^Fmw, Gd, Gd, Gd^Es, Gd, Gd^Es, Wwg, Wwg, Gd, Gd^Vo, Hhd, Hhd, Hhd, Hhd, Mm, Mm, Mm
Mm, Mm, Hhd, Hhd, Ha, Mm, Hhd^Fmw, Mm, Mm, Hhd, Gd, Gd, Gd, Gd^Es, Re, Re, Gd^Fmw, Gd^Fmw, Gd, Gd^Vo, Gd, Gd^Fmw, Wwg, Wwg, Gd^Fmw, Gd, Hhd, Hhd, Mm, Mm, Mm, Mm, Mm
Hhd, Mm, Hhd^Fmw, Hhd^Fma, Ha^Fma, Ha, Hhd^Fmw, Hhd^Fmw, Hhd^Fmw, Hhd, Gd, Gd^Fmw, Gd, Re, Gd, Gd, Gd, Gd, Gd, Gd, Gd, Gd, Wwg, Gd, Gd^Fmw, Gd^Fmw, Re, Hhd, Co, Ko, Hhd, Mm, Mm
Hhd, Hhd, Hhd^Fmw, Hhd^Fmw, Hhd, Hhd^Fma, Hhd, Hhd^Fmw, Hhd, Gd, Gll^Fmw, Gd, Uhe^Fp, Re, Gll^Fp, Hhd^Fmw, Gll^Fp, Gll, Gll, Gll^Fdw, Gll^Fp, Gll^Fp, Wwg, Gll^Fmf, Gll^Fp, Hhd, Hhd, Co, Re, Co, Hhd, Hhd, Mm
Hhd^Fmw, Uhe^Fmw, Gll^Fmf, Gll^Fp, Hhd, Gll^Fp, Gll^Fmw, Gll^Fmw, Gll^Fmw, Gll^Fmf, Gll^Fmw, Gll, Gll, Gll^Fp, Gll^Fmw, Hhd, Gll^Fp, Gll, Gll^Fp, Gll^Fdw, Gll^Fmf, Wwg, Uhe^Fp, Uhe^Fmf, Gll^Fmw, Gd, Uhe^Fdw, Re, Re, Re, Hhd^Vo, Mm, Hhd
Gll^Fmw, Gll^Fmw, Gll^Fp, Hhd, Gll^Fp, Gll^Fp, Gll^Fmw, Gll^Fp, Uhe^Fp, Gll^Fp, Uhe^Fmw, Gll^Fp, Gll, Uhe^Fmw, Uhe^Fmf, Gll^Fp, Gll^Fp, Gll^Fp, Gll^Fp, Gll^Fp, Gll^Fp, Wwg, Wwg, Gll^Fmw, Uue^Fmw, Gll^Fp, Gll^Edt, Gd, Gll^Fp, Hhd, Gd^Edt, Hhd, Hhd
Gll^Fp, Gll^Fp, Gll^Fp, Hhd, Gll^Fp, Hhd^Fmw, Uhe^Fmf, Gll^Fmf, Gll^Es, Gll^Vo, Hhd^Fp, Gll^Fp, Gll^Fmf, Gll^Fp, Gll^Fp, Gll^Fp, Gll^Fp, Gll^Fp, Hhd, Gll^Fp, Gll^Fp, Wwg, Wwg, Gll^Fp, Uhe^Fp, Gll^Edt, Gll^Edt, Uhe^Fmf, Uhe^Fdw, Gll^Fp, Gll^Fp, Gd, Gd
Gll^Fp, Uhe^Fmf, Gll^Fp, Gll^Fp, Uhe^Fp, Uhe^Fp, Gll^Fmw, Gll^Es, Hhd^Fmw, Gll^Fp, Gll^Fmf, Gll^Fp, Gll^Fp, Gll^Fp, Gll^Fmf, Gll^Fmw, Gll^Fp, Gll^Fmw, Gll^Em, Gll^Fp, Gll^Fmf, Uhe^Fp, Wwg, Wwg, Hhd^Fmw, Gll^Fmw, Gll^Fp, Gll^Vo, Uhe^Fp, Gll^Fp, Hhd, Gd, Gd
Uhe^Fp, Uhe^Fp, Gll^Fmf, Gll^Fp, Uhe^Fmw, Gll^Fp, Gll^Fp, Gll^Fp, Uhe^Fmf, Gll^Fp, Gll^Fp, Gll, Gll^Fp, Gll^Fp, Gll^Fp, Hhd^Fp, Gll^Fp, Gll^Fp, Hhd, Gll^Fmf, Gll^Fp, Gll^Fmf, Gll^Fmw, Wwg, Wwg, Uhe^Fmw, Gll^Fp, Gll, Gll^Fp, Gll^Fp, Gll^Fdw, Gll^Fp, Uhe^Fmf
Gll^Fmw, Gll^Fmw, Gll^Fmw, Gll^Fmf, Gll^Fmw, Gll^Fp, Gll^Vo, Uhe^Fp, Uhe^Fmw, Gll^Fp, Gll^Fp, Gll^Fp, Uhe^Fmf, Hhd^Fmw, Gll^Em, Hhd^Fmw, Gll^Fmw, Uhe^Fp, Gll^Fp, Gll^Vo, Gll^Fp, Gll^Fp, Uhe^Fmw, Wwg, Wwg, Uhe^Fmf, Hhd^Fmf, Gll^Fp, Wwg, Hhd^Fp, Gll^Fp, Gll^Fp, Hhd^Fmw
Gll^Fp, Gll^Feth, Gll^Fp, Uhe^Fmf, Uhe^Feth, Gll^Fp, Gll^Fp, Hhd^Fmf, Uhe^Fmw, Gll^Fp, Gll^Fp, Gll^Fmw, Uhe^Fmw, Gll^Em, Gll^Fmw, Gll^Fp, Gll^Fp, Gll^Fp, Gll^Fmw, Gll^Fp, Uhe^Fp, Gll^Fp, Gll^Fp, Uhe^Fp, Uhe^Fp, Wwg, Wwg, Wwg, Wwg, Wwg, Wwg, Wwg, Wwg
Gll^Fp, Gll^Fp, Gll^Fp, Gll^Fp, Gll^Fp, Gll^Fmw, Gll^Fp, Gll^Fmw, Gll^Fmw, Gll^Fp, Uhe^Fp, 3 Gll^Fp, Gll^Fp, Uhe^Fmf, Gll^Fp, Gll, Gll^Fp, Uhe^Fmw, Gll^Fp, Gll^Fmw, Uhe^Fmw, Gll^Fp, Uhe^Fp, Gll^Fp, Gll, Wwg, Gll^Fp, Hhd^Fp, Gll^Fmw, Wwg, Uhe^Fp, Wwg, Gll^Fp
Gll^Fp, Gll^Fp, Gll^Fp, Gll^Fp, Gll^Fp, Uhe^Fmw, Uhe^Fmw, Gll^Fp, Uhe^Fmf, Uhe^Fp, Gll^Fp, Uhe^Fmw, Gll^Fp, Gll^Fp, Gll^Fp, Gll^Fp, Uhe^Fp, Gll^Em, Uhe^Fmw, Gll^Fmw, Gll^Fp, Gll^Fp, Gll^Fp, Gll^Fp, Gll^Fp, Gll^Fmw, Uhe^Fp, Hhd, Gll^Fp, Gll^Fmw, Uhe^Fmw, Uhe^Fp, Gll^Fmw
Gll^Fp, Hhd, Uhe^Fmw, Gll^Fp, Uhe^Fp, Gll^Fp, Gll^Fp, Gll^Fmw, Gll^Fp, Gll^Fp, Gll^Fp, Gll^Fp, Gll^Fp, Gll^Fp, Gll^Fp, Hhd, Gll^Fdw, Gll^Fmw, Gll^Fmw, Gll^Fp, Uhe^Fp, Gll^Vo, Hhd, Gll^Fp, Uhe^Fmf, Gll^Fp, Gll^Fmf, Gll^Vo, Uhe^Fmw, Uhe^Fmw, Gll^Fp, Gll^Fmw, Gll^Fp
Gll^Fp, Uhe^Fp, Gll^Fp, Gll^Fp, Gll^Fmw, Gll^Fp, Gll^Fp, Uhe^Fp, Gll^Vo, Uhe^Fp, Uhe^Fp, Gll^Fp, Gll^Fmw, Gll^Fp, Gll^Fp, Gll^Es, Gll^Es, Gll^Fmw, Uhe^Fp, Gll^Fp, Gll^Fmf, Gll^Fmw, Hhd^Fp, Gll^Fp, Gll^Fp, Gll^Fp, Gll^Fmw, Gll^Fp, Gll^Fp, Gll^Fp, Gll^Fp, Uhe^Feth, Gll^Fp
Uhe^Fp, Gll, Uhe^Fmw, Gll^Fp, Hhd^Feth, Hhd^Fp, Gll^Fp, Gll^Fmw, Gll^Fp, Uhe^Fp, Hhd^Fmw, Gll^Fp, Gll^Fmw, Gll^Fp, Gll^Fp, Gll^Vo, Gll^Fmw, Gll^Fmw, Gll^Fp, Gll^Fp, Hhd, Uhe^Fdw, Uue^Fmf, Gll^Fp, Gll^Fp, Uhe^Fp, Hhd, Gll^Fp, Uhe^Fmf, Uhe^Fdw, Gll^Fmw, Uhe^Fp, Hhd^Fmw
Gll^Fp, Hhd, Gll^Fp, Uhe^Fp, Gll^Fp, Hhd^Fmw, Gll^Fp, Gll^Fp, Uhe^Fp, Gll^Fp, Gll^Fp, Gll^Fmw, Gll^Fp, Uhe^Fmw, Gll, Uhe^Fmf, Uhe^Fmw, Gll^Fmf, Gll^Fmf, Uhe^Fp, Gll^Fp, Uhe^Fp, Gll^Fmw, Gll^Em, Gll^Fp, Gll^Fp, Uhe^Fmw, Gll^Fmw, Gll^Fp, Uhe^Fmw, Uhe^Feth, Uhe^Fp, Uhe^Fmw
Gll^Fp, Hhd, Gll^Fp, Uhe^Fmw, Gll^Fmw, Gll^Fp, Hhd, Gll^Fmw, Gll^Fp, Gll^Fp, Gll^Fp, Gll^Fmw, Gll^Fp, Uhe^Fp, Gll^Fp, Gll^Fp, Gll^Fp, Gll^Fp, Gll^Fp, Gll^Fp, Gll, Gll^Fmw, Hhd^Fp, Gll^Em, Gll^Fp, Gll^Fp, Gll^Fp, Gll^Fp, Gll^Fp, Gll^Fp, Gll^Fp, Gll^Fp, Gll^Fp
Gll^Fp, Gll^Fp, Gll^Fp, Hhd, Gll^Fp, Gll^Fp, Uhe^Fmw, Gll^Fp, Gll^Fmw, Gll^Fp, Gll^Fp, Hhd^Fmw, Gll, Gll^Fp, Gll^Fp, Gll^Fp, Gll^Fp, Gll^Fp, Gll^Fp, Gll^Fp, Hhd^Fmw, Gll^Fp, Gll^Fp, Gll^Fp, Gll^Fp, Gll^Fp, Uhe^Fmw, Gll^Fp, Gll^Fp, Gll^Fdw, Gll, Gll^Fp, Gll
Gll^Fmw, Gll^Fp, Gll^Fp, Gll^Fp, Gll^Fmw, Gll^Fdw, Hhd, Gd, Gll^Fdw, Uhe^Fp, Gll^Fp, Gll^Fp, Gll, Gll, Gll^Fp, Uhe^Fmw, Gll^Fmw, Gll^Fp, Gll^Fp, Hhd, Gll^Fp, Gll^Fmf, Gll, Gll, Gll, Gll, Gll, Gll, Gll, Gll^Vo, Gd, Gll, Gd
Uhe^Fmw, Gll^Fp, Gll^Fp, Hhd^Fp, Gll^Fmw, Gll^Fp, Hhd^Vo, Gll^Fmw, Gll^Fp, Hhd^Fmw, Gll^Fp, Gll^Fp, Hhd^Fp, Gll, Gll^Fmf, Uhe^Fmw, Gll^Fp, Gll^Fmw, Gll, Gll, Re, Re, Re, Gll, Gd, Gll, Gd, Gll, Gd, Gd, Rd^Es, Gd, Gd
Hhd, Uhe^Fp, Gll^Fp, Gll^Fp, Gll^Fmw, Hhd^Fp, Hhd, Gll^Fdw, Hhd, Gll^Fp, Hhd, Gll, Gll, Gll, Gll, Gll, Gll, Gll, Gd, Re, Co, Co, Co, Re, Gd, Gd, Rd, Gd, Gd, Rd^Es, Rd^Dr, Rd^Es, Gd
Mm, Hhd, Mm, Hhd, Mm, Mm, Mm, Mm, Hhd, Hhd, Hhd, Gll, Gll, Gll, Hhd, Gll, Rd, Gd, Gd, Re, Co, 1 Ko, Co, Re, Gd^Edt, Gd^Edt, Rd^Es, Rd, Gd, Rd^Es, Rd^Es, Rd^Es, Gd
Mm, Mm, Mm, Mm, Mm, Mm, Mm, Mm, Mm, Mm, Hhd, Hhd, Hhd, Hhd^Vo, Hhd, Hhd, Rd^Es, Rd^Es, Rd^Es, Re, Re, Co, Re, Re, Gd, Rd^Es, Rd^Dr, Rd^Es, Gd^Edt, Rd, Gd, Gd, Gd
Mm, Mm, Mm, Mm, Mm, Mm, Mm, Mm, Mm, Mm, Mm, Mm, Mm, Hhd, Hhd, Rd, Rd^Es, Rd^Dr, Rd^Es, Gd, Gd, Re, Re, Gd, Rd, Rd^Es, Rd^Es, Rd^Es, Rd, Gd, Gd, Gd^Edt, Gd
Mm, Mm, Mm, Mm, Mm, Mm, Mm, Mm, Mm, Mm, Mm, Mm, Mm, Mm, Hhd, Hhd, Hhd, Rd^Es, Gd, Gd, Gd, Gd, Re, Re, Gd, Gd, Gd, Gd, Gd, Gd, Gd, Gd, Gd
