Ms, Mm, Ms, Ms, Ms, Ms, Ms, Mm, Mm, Mm, Mm, Gs, Re^Edb, Gg^Edt, Ms, Ms, Ms, Ms, Ms, Mm, Mm, Mm, Mm, Gg, Mm, Gg, Mm, Gg, Mm, Mm, Mm, Hh, Hh, Gs, Gg, Gg^Es, Re, Gg, Gll^Es, Gs, Gs
Ms, Ms, Ms, Ms, Ms, Mm, Mm, Mm, Mm, Mm, Mm, Ha, Re, Ha, Mm, Ms, Ms, Ms, Mm, Mm, Mm, Mm, Mm, Mm, Hh, Mm, Mm, Mm, Hh, Mm, Hh, Hh, Gll, Gg, Gd^Es, Re^Es, Gd, Gs, Gs, Gll, Hh
Ms, Ms, Ms, Ms, Ms, Ms, Mm, Wwrg, Wog, Mm, Hh, Mm, Gd^Edb, Re^Es, Mm, Mm, Mm, Mm, Mm, Mm, Hh, Hh, Hh, Hh, Gg^Dr, Hh, Re, Hh, Re, Hh, Gs, Hh, Re, Gs, Re, Re, Hh, Hh, Hh, Hh, Hh
Ms, Ms, Ms, Ms, Ms, Mm, Mm, Hh, Wog, Hh, Gs, Co, Re^Edb, Re, Co, Mm, Mm, Mm, Hh, Mm, Gll^Dr, Re, Hh, Hh, Hh, Gs^Gvs, Re, Co, Re, Gd, Gd^Vo, Re, Gs, Re, Hh, Gd^Vo, Hh, Mm, Mm, Mm, Mm
Mm, Mm, Ms, Mm, Mm, Mm, Hh, Hh, Wog, Gd, Gg, Gs^Edb, Re^Es, Gs^Edb, Gs^Gvs, Gll, Re, Re, Re, Re, Re, Re, Re, Gs^Gvs, Re, Gs^Vo, Re, Re^Edb, Re, 3 Re, Re, Re, Gd, Hh, Hh, Hh, Hh, Mm, Mm, Mm, Ms
Mm, Mm, Mm, Mm, Hh, Mm, Hh, Gs, Wwrg, Wog, Gs, Gll, Gg, Re, Re^Es, Re^Vo, Re^Es, Co, Co, 2 Ko, Co, Co^Es, Re, Re^Vo, Re, Re, Re, Re^Edb, Co, Re, Gs^Es, Hh, Hh, Hh, Mm, Hh, Mm, Hh, Mm, Mm, Ms
Mm, Mm, Mm, Mm, Hh, Hh, Re^Vo, Re, Wog^Bw\, Wog, Re, Gd, Gd^Gvs, Re^Vo, Re, Re, Re, Co^Edb, Co^Edb, Kte^Edb, Co^Es, Cer^Es, Re^Es, Re^Es, Re^Vo, Gd, Gs, Hh, Hh, Hh, Mm, Hh, Mm, Mm, Mm, Mm, Mm, Mm, Ms, Ms, Ms
Mm, Mm, Hh, Wog, Wog, Re, Re, Wog, Wwg, Re, Hh, Re, Re, Re, Re^Vo, Gs, Re, Co^Edb, Re^Edb, Co, Re, Cer^Es, Re, Gd^Es, Gs^Gvs, Gll^Es, Hh, Hh, Mm, Mm, Mm, Mm, Ms, Ms, Ms, Ms, Ms, Mm, Ms, Ms, Ms
Mm, Hh, Hh, Hh, Wog, Co, Wog, Wog, Gs, Hh, Hh, Gd, Gs, Gd, Gd^Gvs, Re^Es, Gd, Re^Edb, Rb, Rb^Edb, Rb, Re^Es, Re^Es, Gd^Gvs, Gg^Gvs, Hh^Fp, Hh, Mm, Hh, Mm, Hh, Mm, Mm, Ms, Mm, Ms, Ms, Ms, Ms, Ms, Ms
Gll^Fdf, Hh^Fmf, Gll^Fdf, Hh, Hh, Wog, Wog, Wwrg, Hh, Hh, Mm, Hh, Gs, Gg^Gvs, Gd^Gvs, Gd^Gvs, Gll^Edb, Rb, Rd^Edb, Rd^Edb, Rd^Edb, Rb^Es, Gs, Re^Vo, Gg, Hh, Gll^Fp, Hh^Fp, Hh, Hh, Mm, Mm, Mm, Mm, Mm, Mm, Mm, Ms, Ms, Ms, Ms
Wog, Ww^Ewl, Wog, Wog, Wog, Wog, Gll^Fdf, Gs, Mm, Mm, Hh, Hh, Hh, Gg, Gd, Re^Vo, Re, Rb, Rd^Edb, Rd^Edb, Rd^Edb, Rb, Gd^Gvs, Gd^Gvs, Gg^Fp, Gll^Fmf, Gll^Fp, Hh, Mm, Mm, Mm, Mm, Mm, Mm, Mm, Mm, Mm, Ms, Ms, Ms, Ms
Wog, Wog, Ww^Ewl, Wwrg, Hh, Wog, Mm, Mm, Ms, Mm, Hh, Hh, Gg, Gg, Gll, Gll^Edb, Gll, Rb, Rb, Rd^Edb, Rb, Rb, Gd^Es, Gll^Gvs, Hh^Fp, Hh^Fp, Gll^Fmf, Hh, Hh, Mm, Mm, Hh, Hh, Mm, Mm, Mm, Ms, Ms, Ms, Ms, Ms
Hh, Hh, Hh^Fdf, Gll^Fmf, Hh^Fdf, Wog, Hh^Fdf, Mm, Ms, Mm, Mm, Hh, Hh, Gg, Co, Gg, Ko, Gd, Ko, Rb, Ko, Gd, Ko, Gll, Co, Gll^Fmf, Hh^Fp, Gll^Fp, Hh^Fp, Hh^Fp, Gll^Fp, Hh, Mm, Mm, Ms, Ms, Ms, Ms, Ms, Ms, Ms
Hh, Hh, Hh^Fmf, Hh^Fmf, Mm, Mm, Hh, Mm, Mm, Mm, Hh, Hh, Re^Es, Cer, Re^Es, Co, Re^Es, Ko, Re^Es, Rb, Re^Es, Ko, Re, Co, Re^Fmf, Cer, Re^Fp, Hh^Fp, Hh^Fp, Hh^Fp, Hh, Hh, Mm, Ms, Mm, Mm, Mm, Ms, Ms, Ms, Ms
Hh, Hh, Hh^Fmf, Mm, Mm, Mm, Mm, Mm, Hh, Hh, Hh, Hh, Gs^Em, Re^Es, Gs^Gvs, Re^Es, Gs^Gvs, Re^Es, Gs^Es, Rb, Gs^Es, Re^Es, Gg^Es, Re^Es, Gs^Es, Re^Fmf, Gs^Es, Gll^Fp, Gg^Fp, Hh, Hh, Mm, Gll^Fdf, Mm, Hh, Mm, Mm, Mm, Mm, Ms, Ms
Mm, Mm, Mm, Mm, Ms, Mm, Hh, Mm, Hh, Hh, Gg, Gll, Gd^Edb, Gs^Gvs, Re^Vo, Gs^Gvs, Rb, Gs, Rb, Rb, Gs, Gs, Gs, Gg, Gg, Gg, Gg^Fp, Gll^Fdf, Hh^Fp, Hh, Gll^Fmf, Gll^Fp, Gll^Fmf, Hh, Hh, Hh, Mm, Mm, Ms, Ms, Ms
Mm, Mm, Mm, Ms, Ms, Mm, Mm, Hh, Hh, Gs, Gd^Es, Gs, Gs^Gvs, Gll^Edb, Rb, Rb, Gd^Es, Rb, Gd, Gs, Gll^Fp, Gd, Gll^Fp, Gll, Gg, Gg^Fp, Gg^Fp, Gll^Fdf, Gll^Fdf, Gll^Fdf, Hh^Fp, Gll^Fp, Mm, Mm, Mm, Mm, Ms, Mm, Ms, Ms, Mm
Mm, Mm, Mm, Ms, Ms, Mm, Mm, Mm, Hh, Hh, Re, Gd, Gd, Rb, Gs^Gvs, Gd, Gll^Fp, Gs^Es, Gll^Fp, Gll, Gll^Fp, Gll^Fp, Gll^Fp, Gll^Fp, Gll^Fp, Gd^Edb, Gll^Es, Gs, Gg^Fp, Gll^Fdf, Gll^Fdf, Hh, Mm, Mm, Ms, Ms, Ms, Ms, Mm, Mm, Mm
Mm, Ms, Ms, Ms, Ms, Ms, Ms, Hh^Fmf, Hh, Hh, Hh, Re^Vo, Rb, Rb, Gs^Gvs, Gs, Gll^Fp, Gll^Fp, Gll^Fp, Gll^Fp, Gll^Fp, Gll^Fp, Gll^Em, Gll^Fp, Gll^Fp, Gll^Fp, Gs^Edt, Gg^Fp, Gg^Fp, Gd, Gd, Gs, Mm, Mm, Ms, Ms, Mm, Mm, Mm, Mm, Gll^Fdf
Ms, Ms, Ms, Ms, Mm, Ms, Mm, Mm, Mm, Hh, Gs^Gvs, Gs^Gvs, Rb, Gs^Gvs, Gs^Es, Gll^Eb, Gll^Fdw, Gll^Fp, Gll^Fdw, Gll^Fp, Gll^Fmf, Gll^Em, Gll^Fp, Gll^Fp, Gll^Fp, Gll^Fp, Gll^Fp, Gd^Es, Re, Gs^Em, Hh^Fp, Gll^Fp, Hh^Fp, Mm, Mm, Mm, Mm, Mm, Gg^Fp, Gll^Fmf, Hh^Fp
Ms, Ms, Ms, Ms, Mm, Mm, Gll^Fmf, Mm, Hh^Fmf, Hh, Hh^Fmf, Gs^Gvs, Rb, Gll, Gll^Fp, Gll^Fp, Gll^Fp, Gll^Fdf, Gll^Fmf, Gll^Fp, Gll^Fp, Gll^Fp, Gll^Fdf, Gll^Fp, Gll^Fp, Gll^Fp, Gll^Fp, Gs, Gll^Fp, Gll, Gll^Fp, Gll^Fdf, Re, Mm, Mm, Mm, Mm, Gll^Fp, Gll^Fp, Hh^Fp, Gg^Fp
Ms, Ms, Ms, Ms, Mm, Mm, Mm, Gg^Fmf, Hh^Fmf, Hh, Gd^Gvs, Gd, Rb, Gs^Edt, Gll^Em, Gll^Fp, Gs^Es, Gll^Fp, Gll^Fdw, Gs^Efm, Gll^Fp, Gll^Feth, Gll^Em, Gll^Fp, Gll^Fmw, Gll^Fp, Gll^Fmf, Gll^Fp, Gll^Fp, Gll, Re, Re, Gg^Vc, Gll^Fp, Hh^Fp, Mm, Hh, Hh^Fp, Gll^Fp, Gll^Fp, Gll^Fp
Ms, Ms, Mm, Ms, Mm, Mm, Gll^Fp, Hh, Hh, Gs^Gvs, Re^Vo, Rb, Gll, Gd, Gll^Fdf, Gll^Fdw, Gll^Fmw, Gll^Fp, Gll^Fp, Gll^Fp, Gll^Fp, Gll^Fp, Gll^Fp, Gll^Fp, Gll^Fmf, Gll^Fp, Gll^Fdf, Gll^Fp, Gll^Fdf, Gll^Fp, Gs, Gs^Gvs, Gll^Fdf, Gg^Fp, Hh^Fp, Hh^Fp, Gll^Fp, Gll^Fdf, Gll^Fdf, Gll^Fp, Hh^Fp
Ms, Mm, Hh, Mm, Mm, Mm, Mm, Gll^Fp, Gd^Edb, Hh, Rb, Rb, Gs^Em, Gll^Fdw, Gll^Fdw, Gll^Fp, Gll^Fdw, Gll^Fmw, Gll^Fp, Gll^Fp, Gs^Es, Gll^Fp, Gll^Fp, Gll^Fp, Gll^Fp, Gll^Fp, Gll^Fp, Gll^Fp, Gll^Fp, Gll^Fp, Gs, Gs, Gs, Hh, Hh, Hh, Hh, Hh, Hh^Fp, Hh^Fp, Hh^Fp
Mm, Mm, Hh, Hh, Mm, Mm, Gs^Fmf, Gg^Fmf, Gd, Hh^Fmf, Rb, Gd, Gg, Gll^Fdw, Gll^Fdw, Gll^Fdw, Gs^Em, Gll^Fdw, Gll^Fdw, Gll^Fmw, Gs^Em, Gll^Fmw, Gll^Fp, Gll^Fdf, Gll^Fmw, Gll^Fp, Gll^Fp, Gll^Fdw, Gll^Fp, Gg, Gll^Fdf, Gg^Fdf, Hh, Hh, Hh, Hh, Hh, Hh, Hh, Hh^Fp, Hh^Fp
Mm, Mm, Mm, Hh, Gll^Fp, Mm, Hh, Hh^Fmf, Gs^Gvs, Gs^Gvs, Rb, Gd, Gs, Gll^Fdw, Gll^Fdw, Gll^Fdw, Gll^Fdw, Gll^Em, Gll^Fdw, Gll^Fdw, Gll^Em, Gs^Em, Gll^Fp, Gll^Fp, Gll^Fdw, Gll^Fmf, Gll^Eb, Gll^Fp, Re, Re, Gll, Gll^Fmf, Hh, Hh, Mm, Mm, Hh, Hh, Hh, Hh^Fp, Hh^Fp
Mm, Hh, Hh, Hh, Hh, Hh, Hh, Gll, Re^Vo, Gs^Gvs, Rb, Gs^Gvs, Gs^Gvs, Gd^Es, Gll^Fdw, Gll^Fdw, Gll^Fdw, Gll^Em, Gll^Fdw, Gll^Fdw, Gll^Fdw, Gll^Fp, Gll^Fp, Gll^Fp, Gg^Edt, Gg, Gs, Gs, Re, Gg^Fmf, Hh, Hh, Hh^Fmf, Mm, Mm, Mm, Wog, Wog, Wog, Hh^Fp, Wwr
Hh, Hh, Hh^Fmf, Hh, Gg^Fmf, Gs^Es, Gs^Gvs, Gs^Gvs, Gs^Gvs, Re, Gs^Es, Rb, Gs^Gvs, Gs, Gs, Gll^Fdw, Gg^Es, Gll^Fdw, Gll^Fdw, Gll^Fdw, Gll^Fdw, Gll^Fdw, Gll^Fp, Gs^Es, Gll^Fp, Gs, Gll^Es, Re, Gll^Fdf, Hh^Fmf, Hh^Fmf, Hh, Ms, Ms, Mm, Wwrg, Hh, Gs, Gs^Fp, Wog, Wwr
Hh, Hh, Gll^Fp, Hh, Hh, Hh^Fmf, Re^Es, Gd^Edb, Re, Gll^Gvs, Gd^Gvs, Rb, Rb, Gs^Gvs, Gs, Gs, Gs, Gll^Fdw, Gg^Es, Gll^Fdw, Gll, Gll^Fdw, Gll^Edb, Gll^Fp, Gg, Gs, Gs^Gvs, Re, Hh, Hh^Fmf, Mm, Mm, Mm, Mm, Hh, Hh^Fp, Hh^Fp, Hh^Fp, Wwr, Wog, Wo
Hh^Fmf, Gll^Fmf, Gll^Fp, Hh, Hh, Re, Gll^Edb, Re, Gs, Gg^Vo, Re^Edt, Re, Rb, Gs^Gvs, Gs, Gs, Gs^Gvs, Gs, Gs^Gvs, Gs, Gs, Gll, Gg, Gg, Gg, Gs^Gvs, Gs^Gvs, Gs^Vl, Hh, Hh, Mm, Mm, Mm, Hh, Hh, Hh, Hh^Fp, Gs^Fp, Gll^Fp, Wog, Wo
Gll, Gll^Fp, Gd^Gvs, Re, Re, Re^Dr, Hh, Hh, Hh, Hh, Hh, Hh, Gd, Rb, Rb, Gs, Gg^Vo, Gs^Gvs, Gg^Gvs, Gs^Gvs, Gs^Gvs, Gll, Gg^Gvs, Gd, Gll, Gll^Fdf, Gll^Fp, Gll^Fmf, Gg^Fp, Hh, Wwg, Mm, Hh^Fp, Hh, Gll^Fmf, Gll^Fp, Hh^Fp, Hh, Gll^Fmf, Wog, Wog
Gll, Gll, Gg^Vo, Gg^Gvs, Hh, Hh^Fmf, Hh, Mm, Mm, Mm, Hh, Gg, Gd, Gs, Rb, Re, Re, Gg^Gvs, Gs^Gvs, Gg^Gvs, Gll, Gd^Vo, Gll, Gs^Gvs, Gd, Gg, Gll^Fdf, Gll^Fdf, Gs^Fp, Gll^Fp, Wwg, Hh, Wog, Hh, Hh, Hh, Mm, Mm, Hh, Hh, Wwr
Gll, Gll, Gg^Gvs, Gg^Gvs, Hh^Fmf, Hh, Mm, Mm, Mm, Mm, Hh, Hh, Gll^Es, Gg, Gs, Rb, Co, Gs^Gvs, Cer, Gd, Co, Gg, Co, Gg^Gvs, Gg, Gll^Fdf, Gll^Fdf, Hh^Fp, Wwrg, Gll^Fdf, Wog, Wog, Gs^Fp, Wwrg, Mm, Mm, Ms, Mm, Hh, Gd, Re
Gs, Gll, Hh, Gg^Fmf, Hh, Hh, Mm, Mm, Hh, Mm, Hh^Fmf, Hh^Fmf, Gg, Gg^Gvs, Gg^Gvs, Gd, Rb, Cer, Co^Edt, Co^Edt, Co^Edt, Co, Gs^Gvs, Gd^Gvs, Gg, Gg^Fdf, Hh^Fp, Gll^Fdf, Wog, Wog, Gll^Fp, Hh^Fp, Hh, Hh, Mm, Mm, Mm, Hh, Hh, Re, Gd
Gs, Gs, Hh, Hh, Chr, Hh, Mm, Mm, Gll^Fp, Hh, Re, Hh^Fmf, Hh^Fmf, Gg^Gvs, Gs^Gvs, Re, Gs, Rb, Rb, 1 Ko^Edt, Rb^Edt, Rb^Edt, Gs, Gg, Gd, Gll^Fdf, Hh, Hh, Wog, Wwg, Gs^Fp, Gs^Fp, Gs^Fp, Gs^Fp, Hh, Wwrg, Hh, Hh, Co, Re, Hh
Hh, Hh, Hh, Hh, Hh, Mm, Chr, Hh, Gs, Hh, Re, Gg^Fmf, Gs, Re^Vo, Re, Re, Gs, Rb, Rb^Edt, Rb^Edt, Rb^Edt, Rb^Edt, Rb^Edt, Gll, Gg, Hh, Gll^Fmf, Wwg, Wog, Gll^Fmf, Hh^Fp, Hh^Fp, Hh, Hh, Wog, Wog, Re, Co^Vo, Co, Hh, Hh^Fp
Hh, Hh, Hh^Fmf, Hh, Hh^Fmf, Chr, Chr^Dr, Hh, Gs, Gd^Edb, Gs, Re, Hh, Gs^Es, Hh, Gg, Gll^Fmf, Gs, Rb, Rb^Edt, Rb^Edt, Rb^Edb, Re^Edt, Gd, Hh, Hh, Hh^Fp, Gll^Fdf, Wwg, Wog, Re^Vc, Gs, Wog, Wog, Wwrg, Re, Hh^Fp, Hh^Fp, Gd, Hh, Hh
Hh, Hh, Hh, Hh, Gll^Fp, Hh, Hh, Gs^Es, Gd^Gvs, Gd^Gvs, Gg, Gs^Edt, Hh, Hh, Gll^Fp, Gg^Fmf, Gll^Fmf, Gd, Gll, Rb, Rb^Edt, Re^Edt, Gs, Re, Re^Es, Re, Re, Re, Wwf, Wwf, Ww^Ewl, Re, Wwf, Re, Re, Re, Hh^Fp, Gll^Fp, Hh, Gs, Gs
Hh, Hh, Hh^Fmf, Hh^Fmf, Gs^Em, Hh^Fmf, Gll, Hh, Gg^Vc, Gd^Gvs, Gll, Hh, Hh, Hh, Hh, Hh^Fmf, Hh, Gll^Fp, Gll^Es, Gs, Rb^Edt, Gll, Gs, Gs, Gs, Gs^Edt, Wog, Wog, Wog, Ww^Ewl, Wog, Wog, Hh^Fp, Gs^Fp, Hh, Hh, Hh, Hh^Fp, Hh, Gs, Gd
Hh, Hh, Hh, Hh^Fmf, Gg, Gg, Gll, Gll^Edb, Gg, Gll, Gg, Hh, Hh, Hh, Hh, Hh^Fmf, Hh, Gll^Fp, Hh^Fmf, Gs, Gll, Rb, Gs, Gs^Es, Gg, Wwg, Wog, Wo, Hh, Hh, Hh, Hh, Hh, Hh, Hh, Hh, Hh, Hh, Hh, Gd, Gd
Hh, Hh, Hh, Hh, Hh, Gg, Gg, Gll, Gg, Hh, Hh, Hh, Hh, Hh, Hh, Hh, Hh, Hh, Gs^Em, Hh^Fmf, Gs^Es, Rb, Gs, Gs, Wwg, Wo, Wo, Hh, Hh, Hh, Hh, Hh, Hh, Hh, Hh, Hh, Gg, Hh, Hh, Hh, Gg
